A|неопределенный артикль
ABANDON|отказываться, покидать, прекращать
ABANDONED|заброшенный 
ABATE|уменьшить
ABBEY|Аббатство
ABBREVIATION|сокращение
ABC|алфавит, азбука, букварь, начатки, основы
ABIDE|ждать, терпеть
ABILITY|способность (-y не от слова capable)
ABLE|способный (-e)
ABOARD|на корабле, на борту, в вагоне
ABODE|местопребывание, жилище (не lodge)
ABOMINABLE|отвратительный, противный
ABOUT|о
ABOVE|над, выше, наверху
ABROAD|за границей
ABRUPT|резкий, внезапный, крутой, обрывистый
ABRUPTLY|внезапно, резко, грубо 
ABSENCE|отсутствие
ABSENT|отсутствующий
ABSOLUTE|совершенный, чистый
ABSOLUTELY|абсолютно, совершенно
ABSORB|поглощать, всасывать, впитывать
ABSORBED|увлечённый чем-либо 
ABSORPTION|Поглощение
ABSTRACT|отвлеченный, абстрактный
ABSURD|нелепый
ABSURDITY|нелепость
ABUNDANCE|богатство, изобилие
ABUNDANT|обильный
ACACIA|акация
ACCENT|подчеркивать, произносить
ACCEPT|принимать
ACCEPTED|принятый
ACCESS|доступ, подход, доступность
ACCESSIBLE|доступный
ACCIDENT|несчастный случай
ACCIDENTAL|случайный, нечаянный
ACCIDENTALLY|случайно, нечаянно
ACCLAIM|провозглашать
ACCOMMODATE|согласовывать, улаживать, примирять
ACCOMMODATION|удобство, согласование
ACCOMPANY|сопровождать
ACCOMPANYING|сопровождающий
ACCOMPLICE|сообщник
ACCOMPLISH|выполнять
ACCOMPLISHED|Выполненный
ACCORD|согласие, гармония
ACCORDANCE|согласованность, согласие, соответствие
ACCORDING|согласно -ing
ACCORDINGLY|согласно
ACCOUNT|счет, оценка, причина
ACCOUNTS|Счета
ACCURACY|точность, аккуратность
ACCURATE|точный, правильный
ACCUSATION|обвинение
ACCUSE|обвинять
ACCUSED|Обвиняемый
ACCUSTOM|приучать
ACCUSTOMED|Приученный
ACHE|боль a-
ACHIEVE|достигать, успешно выполнять a-
ACHIEVEMENT|выполнение, достижение
ACID|кислый, кислота (не sour)
ACKNOWLEDGE|признавать, вознаграждать
ACKNOWLEDGED|Подтвержденный
ACORN|желудь
ACQUAINTANCE|знакомство, знакомый
ACQUIRE|приобретать
ACQUIRED|приобретённый 
ACQUISITION|приобретение
ACQUIT|оправдывать
ACROSS|через
ACT|акт, дело, действовать
ACTED|Действовал
ACTING|временно исполняющий обязанности, игра
ACTION|действие, поступок
ACTIVE|активный
ACTIVELY|активно, деятельно
ACTIVITY|деятельность, активность
ACTOR|актер
ACTRESS|актриса
ACTS|Действия
ACTUAL|текущий, современный
ACTUALLY|фактически, в настоящее время
ACUTE|острый, проницательный
ADAPT|приспособить, переделать
ADAPTED|Приспособленный
ADD|добавлять, прибавлять
ADDITION|прибавление, сложение
ADDITIONAL|дополнительный
ADDITIONS|Дополнения
ADDRESS|адрес, обращение
ADEPT|знаток, сторонник
ADEQUATE|достаточный, соответствующий
ADHERE|прилипать, приставать ( to) , приклеиваться, хвататься
ADJOINING|Смежный -ing
ADJUST|регулировать, приспосабливать
ADJUSTMENT|регулирование *d-
ADMINISTRATION|администрация
ADMINISTRATOR|администратор
ADMIRABLE|замечательный (не wonderful)
ADMIRAL|адмирал
ADMIRATION|восхищение
ADMIRE|восхищаться
ADMIRED|восхищался (от admire)
ADMIRING|Восхищающийся -ing
ADMISSION|допуск, вход, прием
ADMIT|допускать
ADMITTANCE|впуск, доступ a-ce
ADMITTED|Признанный(допущенный)
ADOPT|принимать, присваивать
ADOPTED|Принятый
ADORE|обожать
ADORN|украшать
ADRIFT|по течению, по воле волн
ADS|реклама
ADULT|взрослый
ADULTS|взрослые (от adult)
ADVANCE|продвижение вперед, продвигать
ADVANCED|передовой
ADVANCING|Продвижение -ing
ADVANTAGE|преимущество, выгода
ADVANTAGES|Преимущества
ADVENTURE|рисковать, отваживаться
ADVENTURER|искатель приключений, авантюрист
ADVENTUROUS|отважный, предприимчивый (не undertaking)
ADVERSARY|противник
ADVERSITY|бедствие, несчастье
ADVERTISE|помещать объявление, рекламировать
ADVERTISEMENT|объявление, реклама
ADVICE|cовет
ADVISE|советовать
ADVISED|Рекомендованный
ADVOCATE|отстаивать, защищать
AERIAL|воздушный, антенна
AEROPLANE|самолет
AFAR|далеко, вдали
AFFAIR|дело, занятие
AFFAIRS|делишки 
AFFECT|влиять, трогать, вредить
AFFECTED|пораженный
AFFECTION|привязанность, любовь
AFFECTIONATE|любящий, нежный
AFFECTIONATELY|Нежно
AFFECTIONS|Привязанности
AFFIRMATIVE|утвердительный
AFFORD|позволить себе
AFFORDED|Предоставляемый *f-
AFFRAY|пугать
AFORE|перед
AFRAID|испуганный
AFRESH|снова, опять
AFTER|после
AFTERNOON|время после полудня
AFTERWARD|Позже
AFTERWARDS|впоследствии, позже
AGAIN|снова
AGAINST|против
AGE|век, возраст
AGED|старый, в возрасте
AGENCY|агентство
AGENT|деятель, исполнитель
AGGREGATE|совокупность
AGGREGATED|Соединенный
AGGREGATION|Скопление
AGITATED|Взволнованный *g- (не thrilled)
AGITATION|агитация
AGONY|мучение, сильная боль
AGREE|соглашаться
AGREEABLE|приятный, милый
AGREED|согласился (от agree)
AGREEMENT|согласие, соглашение
AGRICULTURAL|сельскохозяйственный
AGRICULTURE|сельское хозяйство
AHA|Ага
AHEAD|вперед
AID|помощь
AILEEN|Эйлин
AILING|больной -ing
AIM|целиться, цель
AIR|воздушный, авиационный, проветривать
AIRBORNE|авиационный
AIRLINER|лайнер
AIRPORT|аэропорт
AJAR|приоткрытый
ALARM|тревога, (вс)тревожить (alarm)
ALAS|Увы
ALBERT|Альберт
ALBUM|альбом
ALEC|Алек
ALERT|бдительный, проворный
ALEXIS|Алексис
ALFRED|Альфред
ALIAS|Псевдоним
ALIASES|Псевдонимы
ALIBI|Алиби
ALIBIS|Алиби
ALIGHT|выходить, спускаться
ALIGNMENT|выравнивание, линия
ALIKE|похожий
ALIVE|живой
ALL|все, весь
ALLEGIANCE|преданность, верность
ALLEN|Аллен
ALLEY|аллея, переулок
ALLIED|союзный, родственный
ALLOCATE|предназначать
ALLOCATION|распределение, назначение
ALLOW|разрешать, разрешить
ALLOWANCE|дозволение, допущение (allowance)
ALLOWING|Разрешение -ing
ALLOWS|Позволяет
ALLOY|примесь, сплав
ALLUDED|Ссылался
ALLY|союзник, соединять
ALMOND|миндаль, миндалина
ALMOST|почти, едва не (a-)
ALOFT|наверху, наверх
ALONE|один, одинокий
ALONG|вдоль
ALONGSIDE|рядом
ALOUD|громко, вслух
ALPHABET|алфавит, азбука
ALREADY|уже
ALSO|тоже, также
ALTER|изменять
ALTERATION|изменение, перемена
ALTERED|Измененный (не changed)
ALTERNATE|переменный
ALTERNATIVE|альтернатива, выбор
ALTHOUGH|хотя
ALTITUDE|высота (не highness)
ALTOGETHER|всего, в общем
ALWAYS|всегда
AM|(я) есть (от be)
AMATEUR|любитель
AMAZED|изумлённый, поражённый (не wonder) 
AMAZEMENT|удивление, изумление
AMAZING|Удивительный -ing
AMBER|янтарь, янтарный
AMBIGUOUS|двусмысленный
AMBITION|честолюбие, желание
AMBITIOUS|честолюбивый
AMBULANCE|полевой госпиталь, карета скорой помощи
AMENDS|возмещение
AMIABLE|любезный, милый
AMID|между, посреди, среди 
AMMONIA|аммиак
AMMUNITION|боеприпасы
AMONG|среди (не midst)
AMONGST|Среди
AMOROUS|влюбленный, любовный
AMOUNT|количество, сумма, составлять (сумму)
AMPLE|обширный, просторный
AMUSE|забавлять, развлекать
AMUSEMENT|забава, развлечение
AMUSING|забавный, интересный
AMY|Эми
AN|неопределенный артикль (перед гласным звуком)
ANA|сборник изречений
ANALOGOUS|Аналогичный
ANALYSE|анализировать, разбирать
ANALYSIS|анализ
ANCESTOR|предок
ANCHOR|якорь
ANCIENT|древний
AND|и, а
ANEW|снова, заново
ANGEL|ангел
ANGELA|Анжела
ANGELES|Анхелес
ANGER|гнев, злость
ANGLE|угол, точка зрения
ANGLES|Углы
ANGRILY|сердито 
ANGRY|сердитый
ANGUISH|страдание
ANIMAL|животное
ANIMATED|оживленный, анимированный
ANKLE|щиколотка, лодыжка
ANNA|Анна
ANNE|Энн
ANNIHILATION|уничтожение
ANNIVERSARY|годовщина
ANNOUNCE|объявлять
ANNOUNCED|объявлял, объявленный (от announce)
ANNOUNCEMENT|объявление, сообщение
ANNOY|досаждать, надоедать
ANNOYANCE|Раздражение
ANNUAL|годовой, ежегодный, ежегодник (не yearly)
ANNUALLY|ежегодно
ANOMALY|аномалия
ANONYMOUS|анонимный
ANOTHER|еще один, другой
ANSWER|ответ, отвечать
ANSWERED|ответил (от answer)
ANT|муравей
ANTARCTIC|антарктический
ANTHONY|Энтони
ANTICIPATE|предвидеть
ANTICIPATED|Ожидаемый
ANTIDOTE|противоядие
ANTIQUE|древний (не ancient)
ANTIQUITY|древность
ANTONY|Энтони
ANVIL|наковальня
ANXIETY|тревога, беспокойство
ANXIOUS|беспокойный *n-
ANXIOUSLY|тревожно 
ANYHOW|во всяком случае
ANYONE|любой, всякий( утв предлож), кто-нибудь, никто (в отриц предлож) 
ANYWAY|во что бы то ни стало
ANYWHERE|где-нибудь 
APART|в стороне, отдельно (не aside)
APARTMENT|квартира
APE|обезьяна (человекообразная)
APES|Обезьяны
APEX|верхушка, вершина (не peak)
APIECE|за штуку, поштучно
APOLOGIES|извинения (от apology)
APOLOGIZE|извиняться
APOLOGY|извинение
APP|Приложение
APPALLING|ужасный, плачевный -ing
APPARATUS|аппарат
APPAREL|одевать, наряжать
APPARENT|видимый, очевидный
APPARENTLY|явно, очевидно
APPEAL|апелляция, апеллировать (юр.), обращаться
APPEAR|появляться
APPEARANCE|появление, внешность
APPEARED|появился (от appear)
APPEARS|Появляется
APPENDIX|приложение, аппендикс (анат.)
APPETITE|аппетит, охота, желание
APPLAUSE|аплодисменты
APPLE|яблоко
APPLES|яблоки (от apple)
APPLET|Апплет
APPLICATION|заявление, применение
APPLICATIONS|Заявления(применения)
APPLIED|прикладной
APPLY|обращаться, применять
APPOINTED|Назначенный
APPOINTMENT|условленная встреча *pp*...
APPRECIATE|оценивать
APPROACH|приближаться, подступ
APPROBATION|одобрение (не approvement)
APPROPRIATE|подходящий, соответствующий
APPROVAL|одобрение
APPROVE|одобрять
APPROXIMATE|приблизительный
APPROXIMATELY|приблизительно
APRICOT|абрикос
APRIL|апрель
APRON|фартук
APT|подходящий, уместный, склонный
ARABLE|пахотный
ARBITRARY|произвольный
ARBOUR|беседка, дерево, ось
ARC|дуга (мат.)
ARCADIA|Аркадия
ARCH|арка, дуга
ARCHAIC|устарелый, архаический
ARCHED|Арочный
ARCHIE|Арчи
ARCHIPELAGO|Архипелаг
ARCHITECT|архитектор
ARCHITECTURE|архитектура
ARCTIC|полярный, арктический
ARDENT|пылкий
ARDOUR|жар, пыл, рвение
ARDUOUS|тяжелый, напряженный
ARE|есть (от be)
AREA|площадь, район
ARGUE|спорить
ARGUMENT|спор
ARGUMENTS|Аргументы(споры)
ARID|сухой, засушливый
ARISE|возникать, появляться
ARITHMETIC|арифметика
ARM|рука
ARMAMENT|вооружение
ARMED|вооруженный
ARMIES|Армии
ARMOUR|броня
ARMS|оружие
ARMY|армия
AROSE|возник, появился 
AROUND|вокруг, по
AROUSE|будить, пробуждать
AROUSED|разбуженный 
ARRANGE|устраивать, договариваться
ARRANGEMENT|договоренность
ARRANGEMENTS|Меры (не measurements)
ARRAY|массив, множество, наряжать, украшать
ARREST|арестовывать, арест
ARRESTED|Арестованный
ARRIVAL|прибытие
ARRIVE|приезжать
ARRIVED|приехал, прибыл (от arrive)
ARRIVING|прибывающий (-ing)
ARROW|стрела
ARSON|поджог
ART|искусство
ARTFUL|хитрый, ловкий
ARTICLE|статья, предмет, изделие
ARTICLES|предметы (от article)
ARTIFICIAL|искусственный
ARTILLERY|артиллерия
ARTIST|художник
ARTISTIC|художественный
ARTS|Искусства
AS|как, так, в то время как
ASA|Аса
ASCENT|восхождение, подъем a-
ASCERTAIN|установить, удостовериться
ASCERTAINED|Установленный
ASH|ясень
ASHAMED|пристыженный 
ASHES|Пепел
ASHORE|на берег
ASIA|Азия
ASIDE|в сторону
ASK|просить, спрашивать
ASKED|просил, требовал (от ask)
ASKING|спрашивающий, просящий
ASKS|спрашивает (от ask)
ASLEEP|спящий (не sleepy)
ASPECT|взгляд, точка зрения
ASS|осел (библ.)
ASSASSINATION|убийство
ASSAULT|нападать, нападение
ASSEMBLE|созывать
ASSEMBLED|Собранный
ASSEMBLY|собрание, ассамблея
ASSERTED|Утвержденный (не attested)
ASSET|имущество
ASSIGN|назначать
ASSIGNED|Назначенный
ASSIGNMENT|назначение
ASSIST|помочь, помогать
ASSISTANCE|помощь
ASSISTANT|помощник
ASSISTED|Помогал
ASSOCIATE|соединять, присоединять
ASSOCIATION|ассоциация, соединение
ASSORTMENT|выбор, ассортимент
ASSUME|принимать на себя
ASSUMED|Принятый (не adopted)
ASSUMPTION|предположение
ASSURANCE|заверение, уверенность
ASSURE|уверять, обеспечивать
ASSURED|уверенный, застрахованный 
ASTERISK|звездочка
ASTONISHED|удивленный 
ASTONISHING|Удивительный -ing
ASTONISHMENT|удивление, изумление
ASTRONOMY|астрономия
AT|в, у
ATE|ел, съел (от eat)
ATHLETE|спортсмен, атлет
ATHLETICS|атлетика
ATHWART|через, вопреки (не through)
ATLAS|атлас
ATMOSPHERE|атмосфера
ATMOSPHERIC|атмосферный
ATOM|атом
ATTACH|придавать
ATTACHED|Приложенный (не embedded)
ATTACHMENT|привязанность, прикрепление
ATTACK|нападение, наступать
ATTACKED|Атакованный
ATTACKS|Нападения
ATTEMPT|пробовать, пытаться, попытка
ATTEMPTING|Попытка -ing
ATTEMPTS|Попытки
ATTEND|посещать, обслуживать
ATTENDANCE|присутствие, аудитория
ATTENDANT|служитель, слуга
ATTENDANTS|Дежурные
ATTENDED|обслуженный, обслужил (от attend)
ATTENDING|Посещение(сопровождение) -ing
ATTENTION|внимание
ATTENTIONS|Внимание
ATTENTIVE|внимательный, заботливый
ATTEST|удостоверять
ATTIC|чердак
ATTIRE|украшение, наряд
ATTITUDE|позиция, отношение, поза
ATTORNEY|адвокат, поверенный (не advocate)
ATTRACT|привлекать
ATTRACTION|привлекательность, аттракцион
ATTRACTIVE|привлекательный
ATTRIBUTE|приписывать
ATTRIBUTED|Приписанный
AUCTION|аукцион
AUDACITY|отвага, нахальство
AUDIBLE|слышный, слышимый
AUDIENCE|публика
AUDITORIUM|зрительный зал
AUGUST|август
AUNT|тетя
AUTHENTIC|подлинный
AUTHOR|автор
AUTHORITATIVE|авторитетный
AUTHORITIES|Власти
AUTHORITY|власть, полномочие, управление
AUTHORIZE|санкционировать
AUTHORS|Авторы
AUTO|автомобиль
AUTOBIOGRAPHY|автобиография
AUTOGRAPH|Автограф
AUTOMATIC|автоматический
AUTOMATICALLY|автоматически
AUTOMOBILE|автомобиль
AUTUMN|осень
AUXILIARY|вспомогательный, дополнительный
AVAILABLE|доступный
AVALANCHE|снежный обвал, лавина
AVE|прощание
AVENGE|(ото)мстить
AVENUE|проспект
AVERAGE|средний
AVERSION|отвращение
AVOID|избегать, избежать
AWAIT|ждать
AWAKE|бодрствующий
AWAKENED|Пробужденный
AWARE|сознающий
AWAY|прочь
AWE|(благоговейный) страх
AWESTRUCK|пораженный
AWFUL|ужасный
AWFULLY|ужасно, очень (разг.), крайне
AWHILE|некоторое время
AWKWARD|неуклюжий
AWOKE|будил *w- 
AXIS|ось
AY|Да
AYE|Утвердительный ответ, положительный ответ (не yes)
BAB|Бэб
BABBLE|бормотание, болтовня b-
BABY|ребенок
BACK|спина, назад
BACKED|Поддержанный
BACKGROUND|фон, задний план
BACKS|Задние части b-
BACKUP|Резервный *a-
BACKWARD|назад, обратно, наоборот
BACKWARDS|Назад
BACON|бекон
BAD|плохой
BADE|Предлагал
BADGE|знак, символ, эмблема
BADGER|барсук, травить
BADLY|сильно, плохо
BAFFLE|озадачивать, мешать
BAG|сумка
BAGFUL|мешок b-
BAGGAGE|багаж b-
BAGS|сумки, багаж (от bag)
BAIL|поручительство
BAIT|приманка
BAKER|пекарь, булочник
BAKERY|пекарня
BALANCE|равновесие
BALANCED|уравновешенный
BALCONY|балкон
BALD|лысый, оголенный
BALL|мяч
BALLAST|балласт, опыт, убеждения
BALLET|балет
BALLOON|воздушный шар
BALLOONS|Воздушные шары
BALMY|душистый, нежный, целебный
BAMBOO|бамбук
BAN|запрещать
BANANA|банан
BANANAS|бананы (от banana)
BAND|лента, оркестр, ансамбль (музыкальный)
BANDAGE|бинт, повязка, перевязывать, бинтовать
BANDS|ансамбли (от band)
BANDY|перебрасываться, хоккей, клюшка
BANG|ударять, хлопать (дверью и т.п.)
BANGED|ударенный 
BANISTERS|перила (лестницы)
BANK|банк
BANNER|знамя
BANQUET|банкет
BAR|бар
BARBARA|Барбара
BARBED|колючий, ядовитый
BARE|голый, бедный, простой
BAREFOOTED|босой
BARELY|только, едва (b-)
BARGAIN|сделка
BARGE|баржа
BARK|кора дерева
BARLEY|ячмень
BARN|амбар
BARNABAS|Барнабас
BARNACLE|Моллюск
BARON|Барон
BARREL|баррель
BARREN|бесплодный, неплодородный
BARRIER|барьер, преграда
BARROW|носилки
BARS|Бруски(бары)
BARTON|имение, поместье, усадьба (не estate) 
BASE|основа
BASEBALL|бейсбол
BASED|Основанный
BASEMENT|основание
BASIC|основной b-
BASICALLY|в основном
BASIN|бассейн b-
BASIS|основа, основание
BASKET|корзина
BASS|бас, басовый
BAT|бить
BATCH|выпечка, партия, группа
BATES|Убавляет
BATH|ванна
BATHE|купаться
BATHING|купание, купальный
BATHROOM|ванная комната
BATTERY|аккумулятор
BATTLE|бой, сражение
BAY|бухта, залив
BE|быть
BEACH|пляж
BEACON|сигнальный огонь, маяк
BEAGLE|Гончая
BEAK|клюв
BEAKER|кубок, чаша (не rummer)
BEAM|сиять, излучать (свет)
BEAMED|Сиял
BEAMING|Сияющий (от слова beam)
BEAMS|Лучи
BEAN|боб
BEANS|фасоль
BEAR|медведь, спекулянт
BEARABLE|терпимый, сносный b-
BEARD|борода
BEARER|носитель, податель, предъявитель
BEARING|Отношение(поведение) -ing
BEARS|Медведи
BEAST|зверь, животное
BEASTLY|противный (разг.) от слова ЗВЕРЬ!!!
BEASTS|звери 
BEAT|ударить, бить
BEATEN|битый
BEATING|поражение b-
BEAU|кавалер, поклонник
BEAUTIFUL|красивый
BEAUTIFULLY|красиво, прекрасно
BEAUTY|красота, косметический
BECAME|становился, стал (от become)
BECAUSE|потому что
BECK|кивок, приветствие
BECOME|становиться
BECOMES|становится (от become)
BECOMING|подобающий, приличествующий, соответственный, идущий (к лицу) (не eligible, suitable) -ing
BED|постель
BEDDING|спальные принадлежности (bedding)
BEDROOM|спальня
BEDS|Кровати
BEDSIDE|постель
BEE|пчела
BEECH|бук
BEEF|говядина
BEEHIVE|улей
BEEN|быть (от be)
BEER|пиво
BEES|Пчелы
BEETLE|трамбовать, дробить камни
BEETROOT|красная свекла
BEFORE|перед, до того как
BEFOREHAND|заранее
BEG|просить, умолять
BEGAN|начинал, начал (от begin)
BEGGAR|нищий
BEGIN|начинать(ся)
BEGINNER|новичок (не newcomer)
BEGINNING|начало
BEGINS|начинается (от begin)
BEGUN|Начатый
BEHALF|Защита
BEHAVE|вести себя
BEHAVED|Вел себя
BEHAVIOUR|поведение
BEHELD|Созерцал
BEHIND|позади
BEHOLD|Созерцать
BEING|будучи (от be)
BEINGS|Существа
BELFRY|колокольня
BELIEF|вера, доверие
BELIEVE|верить
BELIEVED|верил, полагал (от believe)
BELIEVES|Верит
BELIEVING|Вера -ing
BELL|звонок (b-)
BELLA|Белла
BELLAMY|Беллами
BELLOW|мычание, греметь, громыхать (не rattle)
BELLY|живот, аппетит
BELONG|принадлежать
BELONGED|принадлежащий 
BELONGINGS|вещи, пожитки
BELOVED|любимый
BELOW|ниже, внизу
BELT|пояс, ремень
BEN|Бен
BENCH|скамейка
BEND|гнуться, изгибаться
BENDING|Изгиб b-
BENEATH|под, ниже, внизу
BENEFIT|благо, польза
BENNET|Беннет
BENT|склонность, наклонность
BERENICE|Беренис
BERRIES|ягоды (от berry)
BERTH|койка, спальное место
BERTRAM|Бертрам
BESET|окружать
BESIDE|рядом, около
BESIDES|кроме, кроме того
BEST|наилучший
BESTOWED|Подаренный
BET|держать пари, пари
BETH|Бет
BETRAY|предавать
BETRAYED|Преданный (от слова предательство)
BETTER|лучше
BETTY|Бетти
BETWEEN|между
BEVERLEY|Беверлей
BEWAIL|оплакивать, скорбеть
BEWARE|осторожно *e-
BEWILDERED|пораженный, изумленный b-
BEYOND|далеко, вдали, на расстоянии, вне, сверх
BIBLE|библия
BICYCLE|велосипед
BICYCLELIST|велосипедист
BID|Предложение
BIDDING|понижение цены -ing
BIG|большой
BIGGER|Больший
BIKE|велосипед
BIKES|Велосипеды
BILL|счет, законопроект
BILLION|биллион, миллиард (амер.)
BILLY|Билли
BIN|бункер 
BINARY|Набор из двух предметов
BIND|связывать (не link)
BINDING|переплет -ing
BINGO|Лото
BIOLOGY|биология
BIRCH|береза, розга
BIRD|птица
BIRTH|рождение
BIRTHDAY|день рождения
BISCUIT|сухое печенье
BISHOP|епископ, слон (шахм.)
BIT|кусочек, немного
BITE|кусаться
BITING|острый, резкий b-ing
BITS|куски 
BITTER|горький, мучительный
BITTERLY|горько, сильно
BLAB|болтун, болтать (не от слова chat)
BLACK|черный
BLACKBIRD|черный дрозд
BLACKEN|чернить, чернеть
BLACKENED|Почерневший
BLADDERS|Пузыри
BLADE|лезвие
BLADES|Лезвия
BLAKE|Блак
BLAME|считать виноватым, вина, упрек, порицание (b-)
BLANK|пустой, чистый b-
BLANKET|одеяло
BLAST|взрыв, взрывать, разрушать
BLAZE|пламя, пылать, гореть (не flame)
BLAZING|Сверкание -ing
BLEACH|белить (ткань)
BLEEDING|Кровотечение
BLEND|смешивать, смесь
BLESS|благословлять
BLESSED|благословлённый 
BLESSING|благословение -ing
BLEW|дул 
BLIND|слепой
BLINK|мерцание, отблеск, блеснуть, моргать b-
BLINKED|Мигал
BLISS|блаженство, счастье
BLIZZARD|метель, пурга
BLOB|капля, комочек (не drop)
BLOBS|Капли (не drops)
BLOCK|блок, квартал
BLOCKADE|блокада
BLOCKED|Блокированный
BLOCKS|кварталы (от block)
BLOND|белокурый
BLONDE|блондин
BLOOD|кровь
BLOODY|кровавый
BLOOM|цветение
BLOSSOM|цветок (на деревьях, кустах), расцветать
BLOT|клякса, пятно, промокать
BLOUSE|блуза
BLOW|дуть
BLOWN|Сдутый
BLUE|синий
BLUNT|притуплять
BLUSH|(по)краснеть; краска стыда, смущения b-
BOARD|садиться на пароход, самолет; доска
BOARDING|посадка (самолёта) -ing
BOAST|хвастовство, хвастать
BOAT|лодка, пароход
BOATS|лодки 
BODIES|Органы(тела)
BODILY|лично, сам, собственной персоной (не myself)
BODY|тело
BOG|трясина
BOIL|кипятить, кипеть
BOILED|вареный, кипяченый
BOILER|котел
BOISTEROUS|неистовый, шумный
BOLD|смелый (не dare)
BOLDLY|Смело
BOLT|молния
BOMB|бомба, бомбить
BONDAGE|рабство, зависимость (не slavery)
BONE|кость
BONES|кости 
BONFIRE|костер
BONNET|капор, дамская шляпа
BONUS|премия
BOOK|книга, покупать (билет)
BOOKCASE|книжный шкаф
BOOKING|продажа билетов -ing
BOOKLET|брошюра, буклет
BOOKS|книги (от book)
BOOKSHELF|книжная полка
BOOST|повышение, повышать
BOOT|ботинок, сапог
BOOTH|кабинка
BOOTS|ботинки, сапоги (от boot)
BOOTY|награбленное добро, добыча
BORDER|граница
BORE|скука
BORING|скучный
BORN|рожденный
BORNE|ограниченный, с узким кругозором, узколобый, закостенелый
BORROW|брать в долг
BORROWED|брал в долг, взятый в долг (от borrow)
BOSOM|грудь (не chest)
BOSS|начальник
BOTH|оба
BOTHER|беспокойство, хлопоты; источник беспокойства
BOTTLE|бутылка
BOTTLES|бутылки (от bottle)
BOTTOM|дно, донышко
BOUGH|ветвь, сук
BOUGHT|купил, купленный (от buy)
BOULEVARD|бульвар
BOUNCE|отскакивать
BOUND|непременный, обязательный
BOUNDARY|граница *o-
BOUNDLESS|безграничный
BOUNDS|граница, ограничение (от bound)
BOUT|черед, круг
BOW|кланяться, сгибаться
BOWED|Поклонился
BOWL|кубок, чаша
BOX|ящик, коробка, ложа (театр.)
BOXES|ложи (от box)
BOXING|бокс
BOY|мальчик, юноша
BRACE|связывать, скреплять (не clamp)
BRACES|подтяжки
BRACKET|скобка, подпорка, заключать в скобки
BRADLEY|Брадлей
BRAIN|мозг
BRAKE|тормоз
BRAKES|тормоза (от brake)
BRANCH|ветвь, отрасль
BRANCHES|ветки 
BRAND|головня, клеймо, фабричная марка, сорт, клеймить
BRANDY|коньяк, бренди
BRASS|установить
BRAVE|храбрый, смелый
BRAVELY|смело
BRAVERY|храбрость, смелость *r-
BRAWL|уличный скандал
BREACH|брешь, пробивать брешь
BREAD|хлеб
BREADTH|ширина, полотнище
BREAK|ломать
BREAKFAST|завтрак
BREAST|грудь
BREATH|дыхание
BREATHE|дышать
BREATHING|дыхание
BREATHLESS|запыхавшийся
BRED|Разводимый
BREECHES|брюки, бриджи (не trousers)
BREED|порода
BREEDER|производитель
BREEDING|разведение
BREEDS|Породы
BREEZE|легкий ветер
BREW|затевать, надвигаться
BREWING|затевающий, надвигающийся (от brew)
BRICK|кирпич
BRICKS|кубики (детские)
BRIDE|невеста
BRIDGE|мост
BRIDLE|узда, повод, взнуздывать
BRIEF|короткий, сводка, резюме
BRIEFCASE|портфель
BRIEFLY|кратко, сжато
BRIGADE|бригада
BRIGHT|ясный
BRIGHTLY|Ярко
BRILLIANCE|блеск, великолепие, яркость (не brightness)
BRILLIANT|блестящий, брильянт
BRIM|край, поля (шляпы)
BRING|приносить, приводить
BRINGS|Приносит
BRISK|живой, проворный b-
BRITAIN|Британия
BRITISH|британский
BRITTLE|хрупкий, ломкий (не fragile)
BROAD|широкий
BROADCAST|передача по радио
BROADCASTING|радиовещание
BROADLY|широко
BROKE|(с)ломал, сломанный (от break)
BROKEN|разбитый, сломанный, нарушенный, ломаный (о языке)
BRONZE|бронзовый
BROOCH|брошь
BROOD|высиживать (цыплят), выводок
BROOK|ручей
BROOM|метла, мести
BROTHER|брат
BROUGHT|принес, принесенный (от bring)
BROW|бровь
BROWN|коричневый
BROWS|Брови
BRUISE|ушибать, синяк, ушиб
BRUISES|Ушибы
BRUSH|щетка, чистить щеткой
BRUSHED|Чистил (не cleaned)
BRUTAL|грубый, жестокий
BRUTALLY|грубо, жестоко
BRUTE|зверь, скотина (не beast)
BUBBLE|пузырь
BUCKET|ведро
BUCKWHEAT|гречиха
BUD|почка, бутон, давать почки, пускать ростки
BUDGE|шевелиться
BUDS|почка, расцветать 
BUFFALO|буйвол
BUFFER|Буфер
BUG|клоп, насекомое, жук (амер.)
BUGS|Ошибки(дефекты)
BUILD|строить
BUILDER|строитель
BUILDING|здание
BUILDS|Строит
BUILT|строил, построенный (от build)
BULB|луковица, электрическая лампочка
BULK|груз, величина
BULKY|громоздкий
BULL|бык
BULLET|пуля
BULLY|запугивать (не scare)
BUM|бездельник, бродяга
BUMP|удар, толчок, шишка, ударять(ся), стукаться **m*
BUN|булочка
BUNCH|связка, пучок
BUNDLE|узел, пакет
BUNGALOW|(одноэтажная) дача, бунгало
BUOY|буй, бакен
BURDEN|груз, бремя
BUREAU|бюро, контора
BURGLARY|кража со взломом
BURIAL|похороны
BURIED|спрятанный, похороненный 
BURLAP|холст, мешковина (не canvas)
BURLY|крепкий 
BURN|гореть, жечь, сжигать
BURST|заливаться, разражаться
BURY|хоронить, прятать
BUS|автобус
BUSH|куст
BUSHES|кусты 
BUSILY|Деловито
BUSINESS|дело, бизнес, деловой
BUSINESSMEN|бизнесмены (от businessman)
BUST|бюст
BUSTLE|суетиться, суматоха, суета
BUSTS|Бюсты
BUSY|занятый
BUT|но
BUTCHER|мясник
BUTLER|Дворецкий
BUTTER|масло
BUTTON|кнопка, пуговица
BUTTONS|Кнопки
BUY|покупать, купить
BUYER|покупатель
BUZZ|жужжать, гудеть, жужжание, гул
BUZZER|(фабричный) гудок
BY|по, при, путем
BYE|пока (при прощании)
BYTE|Байт
BYTES|Байты
BYWORD|поговорка, олицетворение (не dictum)
CAB|наемный экипаж, извозчик, такси
CABBAGE|капуста
CABIN|каюта
CABINET|кабинет (не parlour)
CABLE|кабельный
CACHE|Тайник
CADENCE|ритм, интонация
CAESAR|Каесар
CAFE|кафе
CAGE|клетка, кабина
CAGES|Клетки
CAKE|торт
CAKES|пироги 
CALAMITY|стихийное бедствие, большое несчастье
CALCULATE|рассчитывать, вычислять
CALCULATED|Расчетный
CALEB|Калеб
CALENDAR|календарь
CALF|слоненок, теленок, молодой кит
CALL|звонить, называть (call)
CALLED|звонил, названный (от call)
CALLING|звонящий (от call)
CALM|успокаивать
CALMLY|тихо, спокойно 
CAMBRIDGE|Кембридж
CAME|пришел (от come)
CAMERA|фотоаппарат
CAMP|лагерь
CAMPAIGN|компания, проводить кампанию
CAN|уметь, мочь
CANCEL|отменить, сократить
CANDIDATE|кандидат
CANDLE|свеча
CANDLING|Миражирование -ing
CANE|трость, палка
CANES|Тростники(трости)
CANNED|консервированный
CANNON|пушка, орудие c-
CANNOT|не уметь (отрицательная форма глагола can)
CANOE|челн, байдарка
CANTEEN|столовая
CANVAS|холст, парус
CANYON|Каньон
CAP|шапка
CAPABLE|способный
CAPACIOUS|просторный, вместительный, объемистый
CAPACITY|емкость, способность
CAPE|мыс
CAPITAL|столица
CAPITALIST|капиталист, капиталистический
CAPTAIN|капитан
CAPTIVE|пленный
CAPTIVITY|Захват
CAPTURE|захват, поймать
CAPTURED|Захваченный
CAR|машина
CARAVAN|фургон
CARBON|углерод
CARBONATE|Карбонат
CARD|карточка
CARDBOARD|картон
CARDS|карточки (от card)
CARE|заботиться, переживать
CAREER|профессия, карьера
CAREERS|профессии (от career)
CAREFUL|осторожный
CAREFULLY|осторожно, внимательно
CARELESS|беззаботный
CARES|заботится, переживает (от care)
CARGO|груз
CARICATURE|карикатура
CARLA|Карла
CARLOS|Карлос
CARPENTER|плотник
CARPET|ковер, устилать
CARRIAGE|вагон
CARRIER|носильщик, транспортное средство
CARROT|морковь
CARRY|нести, носить, возить
CARRYING|перевозка
CART|телега, повозка
CARTER|возчик; ломовой извозчик 
CARTON|коробка
CARTOON|мультфильм
CARVE|вырезать, отрезать
CARVED|вырезанный (из дерева, из камня) 
CASE|случай, состояние
CASH|деньги
CASKS|Бочки
CAST|бросать, ронять, менять
CASTLE|замок (не железный, а каменный)
CASUAL|случайный (не random)
CAT|кошка
CATCH|уловить, понять, получить нагоняй
CATCHING|Ловля
CATHEDRAL|собор
CATHERINE|Кэтрин
CATS|Коты
CATTLE|(рогатый) скот
CAUGHT|ловил 
CAULDRON|Котел
CAUSE|дело, причина
CAUSING|Порождение -ing
CAUTION|осторожность
CAUTIOUS|осторожный
CAUTIOUSLY|осторожно 
CAVE|пещера
CAVERN|Пещера
CAVITY|впадина, полость
CEASE|прекращать, останавливать
CEASED|Прекратил
CEILING|потолок
CELEBRATE|праздновать
CELEBRATED|праздновал (от celebrate)
CELEBRATION|празднование
CELEBRITY|известность, знаменитость
CELL|камера, ячейка
CELLAR|подвал, винный погреб
CELLS|Ячейки
CEMENT|цемент, основа
CEMETERY|кладбище
CENT|цент
CENTER|центр
CENTRAL|центральный
CENTRE|центр -re
CENTURIES|Столетия
CENTURY|столетие, век
CEREALS|хлебные злаки, зерновые
CEREMONY|церемония
CERTAIN|определенный, некоторый, некий c-
CERTAINLY|конечно
CERTAINTY|уверенность
CERTIFICATE|справка, аттестат
CESSATION|прекращение (не interrupt)
CHAIN|цепь
CHAIR|стул
CHAIRMAN|председатель
CHAISE|Фаэтон
CHALK|мел
CHALKED|Рисовавший мелом
CHALLENGE|вызывать, вызов
CHAMBER|палата
CHAMBERS|Палаты *h-
CHAMPAGNE|шампанское
CHAMPION|чемпион
CHAMPIONSHIP|чемпионат, звание чемпиона
CHANCE|случай, шанс
CHANCES|Возможности
CHANGE|мелкие деньги, сдача, менять, пересаживаться
CHANGED|поменял, изменил (от change)
CHANGES|меняется (от change)
CHANGING|Изменение(замена)
CHANNEL|канал
CHAP|парень (разг.), малый c-
CHAPTER|глава (книги)
CHAPTERS|Главы
CHAR|Случайная работа
CHARACTER|характер
CHARACTERISTIC|особенность
CHARGE|плата, стоимость, взимать плату
CHARGES|издержки, расходы (от charge)
CHARITY|милосердие
CHARLES|Чарльз
CHARLEY|Чарли
CHARLOTTE|Шарлотта
CHARM|очарование
CHARMING|очаровательный, прелестный
CHARMS|Обаяния
CHASE|охотиться, преследовать, погоня, охота
CHASING|уклоняющийся (от chase)
CHAT|беседа, болтовня (не blab)
CHATTER|болтать, болтовня
CHATTERBOX|болтунья
CHAUFFEUR|шофер
CHEAP|дешевый
CHEAPLY|дешево, легко
CHEAT|обманывать, надувать, обманщик, плут c-
CHECK|проверять, регистрировать
CHECKING|Проверка
CHEEK|щека
CHEEKY|развязный
CHEER|настроение
CHEERFUL|жизнерадостный, веселый с-
CHEERFULLY|бодро 
CHEERS|да здравствует (приветственное восклицание)
CHEESE|сыр
CHEMICAL|химический
CHEMIST|химик, аптекарь
CHEMISTRY|химия
CHEQUE|банковский чек
CHERISH|лелеять
CHERRIES|вишни (от cherry)
CHERRY|вишня
CHESS|шахматы
CHEST|грудь
CHESTNUT|каштан
CHEVY|охота, погоня, гнаться (не chase)
CHEW|жевать
CHICKEN|цыпленок, кура
CHIEF|шеф, начальник
CHIEFLY|главным образом
CHILD|ребенок
CHILDHOOD|детство
CHILDISH|детский, ребяческий
CHILDREN|дети
CHILL|холод, простуда
CHILLY|холодный, сухой, чопорный
CHIMNEY|труба c-
CHIN|подбородок
CHINA|фарфор
CHIP|обломок, осколок
CHISEL|резец, ваять, высекать
CHIVALROUS|рыцарский
CHOCOLATE|шоколад
CHOICE|выбор (c-, не choose)
CHOKED|Забитый
CHOOSE|выбирать c-
CHORUS|хор
CHOSE|выбирал, выбрал (от choose)
CHOSEN|выбранный (от choose)
CHRIS|Крис
CHRISTIAN|христианский, христианин
CHRISTMAS|Рождество
CHRONICLE|летопись, хроника, отмечать
CHUCKLED|Хихикал
CHURCH|церковь
CHURCHILL|Черчилл
CHURCHYARD|кладбище
CIGAR|сигара
CIGARETTE|сигарета
CIGARETTES|сигареты (от cigarette)
CINEMA|кино
CIRCLE|амфитеатр, круг
CIRCUIT|кругооборот, окружность
CIRCULAR|круглый, реклама
CIRCULATE|повторяться, передаваться
CIRCULATION|кровообращение, тираж
CIRCUMFERENCE|окружность
CIRCUMSTANCE|обстоятельство, условие
CIRCUMSTANCES|обстоятельства, условия
CIRCUMSTANTIAL|обстоятельный, случайный
CIRCUS|цирк, арена
CITIZEN|гражданин
CITIZENS|Граждане
CITY|город
CIVIL|гражданский (-l)
CIVILIZATION|цивилизация
CLAIM|требовать
CLAIMED|Требуемый
CLAIMS|Требования
CLAMOUR|шум, крики
CLAMP|складывать, скреплять (не brace)
CLANK|бряцать, хлопать в ладоши
CLAP|хлопать, аплодировать; удар, хлопок -p
CLASH|столкновение, конфликт
CLASP|прижимать (к груди), обнимать, сжимать (в руке)
CLASPED|Сжатый (не от слов squeeze, tight)
CLASS|класс (не grade)
CLASSES|занятия, уроки
CLASSIC|классический
CLASSROOM|класс
CLATTER|стук, звон; стучать, греметь
CLAUSE|предложение, статья
CLAW|коготь, клешня
CLAY|глина, земля
CLEAN|чистить, чистый
CLEANED|чистил, (по)чищенный (от clean)
CLEANING|чистка
CLEANLINESS|чистоплотность
CLEANUP|Уборка
CLEAR|ясный, светлый, очищать, расплатиться
CLEARED|рассчитался (от clear)
CLEARING|clearing
CLEARLY|ясно (не obvious)
CLENCH|сжимать (кулаки, зубы)
CLENCHED|Сжатый *l-
CLEOPATRA|Клеопатра
CLERGYMAN|священник
CLERK|чиновник
CLEVER|умный
CLICK|щелкать
CLIENT|клиент
CLIENTS|Клиенты
CLIFF|утес, скала
CLIFFS|Утесы
CLIMATE|климат
CLIMAX|кульминационный пункт
CLIMB|подниматься, влезать
CLING|цепляться, (при)льнуть
CLINK|звенеть, звон
CLIP|стричь, обрезать, зажимать (не trim)
CLOAK|плащ, камера хранения (багажа)
CLOCK|часы (не watch)
CLOSE|закрывать(ся)
CLOSED|закрыл, закрытый (от close)
CLOSELY|близко, тесно
CLOSET|чулан
CLOSING|заключительный
CLOSURE|закрытие
CLOTH|ткань
CLOTHE|одевать
CLOTHES|одежда
CLOTHING|одежда, обмундирование
CLOUD|облако
CLUB|клуб
CLUE|ключ (к разгадке), улика
CLUMSY|неуклюжий
CLUNG|Цеплялся
CLUSTER|гроздь; скопляться, тесниться
CLUTCH|захват (не snatch)
CO|Компания
COACH|тренировать, инструктор
COAL|уголь
COARSE|грубый
COAST|побережье
COAT|пальто
COATS|Пальто
COAX|уговаривать, задабривать
COBBLER|сапожник
COBWEB|паутина
COCK|петух, задирать
COCKTAIL|коктейль
COCOA|какао
COCOON|кокон
CODE|код
COFFEE|кофе
COGNOMEN|прозвище, фамилия (не nickname)
COIL|виток, катушка
COIN|монета
COINCIDENCE|совпадение
COINS|монеты (от coin)
COL|Седло
COLD|холод, холодный
COLIN|Колин
COLLAPSE|крушение, крах, рушиться, потерпеть крах
COLLAR|воротник
COLLATION|Сопоставление
COLLATIONS|Сопоставления
COLLEAGUE|коллега
COLLECT|коллекционировать
COLLECTED|коллекционировал (от collect)
COLLECTION|коллекция
COLLECTIONS|собирание, выемка (от collection)
COLLECTOR|сборщик, коллекционер
COLLEGE|колледж
COLLISION|столкновение
COLON|двоеточие
COLONEL|полковник
COLONIAL|колониальный
COLONIZE|заселять, колонизировать
COLONY|колония
COLOR|Цвет
COLORED|Цветной
COLORFUL|красочный c-
COLOUR|цвет
COLOURED|цветной
COLOURFUL|красочный
COLOURS|цвета (от colour)
COLUMN|графа, отдел
COLUMNS|Колонки
COMB|гребенка, расчесывать, расчесать
COMBAT|бой, борьба (не battle) c-
COMBINATION|комбинация, объединение
COMBINE|объединять (не connect)
COMBINED|Объединенный
COME|приходить, приезжать
COMEDY|комедия
COMELY|хорошенький, миловидный (не pretty, lovely)
COMER|приходящий
COMFORT|удобство, утешение, утешать
COMFORTABLE|удобный
COMIC|кинокомедия, комический
COMICS|комиксы
COMING|приход, приходящий (от come)
COMMA|запятая
COMMAND|приказ, управлять, приказывать
COMMANDER|командир, начальник
COMMANDS|Команды
COMMEND|хвалить
COMMENT|комментарий, комментировать
COMMERCE|торговля, коммерция -e
COMMERCIAL|торговый
COMMISSION|комиссионные
COMMIT|совершать (преступление)
COMMITTED|Совершенный(переданный)
COMMITTEE|комитет, комиссия
COMMON|общий
COMMONLY|обыкновенно, дешево, плохо
COMMONPLACE|банальность, общее место; банальный
COMMOTION|смятение, волнение
COMMUNICATE|сообщать, общаться
COMMUNICATED|Сообщенный
COMMUNICATION|сообщение, связь, общение
COMMUNITY|община
COMPACT|компактный
COMPANION|товарищ
COMPANY|компания, общество (company)
COMPARABLE|сравнимый
COMPARATIVE|сравнительный, относительный
COMPARATIVELY|Сравнительно
COMPARE|сравнивать
COMPARED|сравнил (от compare)
COMPARISON|сравнение
COMPARTMENT|купе
COMPASS|объем, диапазон; компас; циркуль
COMPASSION|жалость, сострадание 
COMPATIBILITY|совместимость 
COMPELLED|Вынужденный
COMPETE|состязаться, конкурировать
COMPETITION|соревнование
COMPILE|составлять
COMPLAIN|жаловаться
COMPLAINT|жалоба
COMPLAINTS|жалобы (от complaint)
COMPLETE|полный, законченный
COMPLETED|Законченный
COMPLETELY|совершенно, полностью
COMPLETION|завершение, окончание
COMPLEX|сложный, составной, комплексный
COMPLEXION|цвет лица
COMPLICATED|сложный
COMPLICATION|сложность
COMPLIMENT|комплимент
COMPLIMENTS|комплименты (от compliment)
COMPLY|уступать, соглашаться
COMPONENT|компонент
COMPOSE|сочинять, составлять
COMPOSED|спокойный
COMPOSITE|составной, сложный
COMPOSITION|сочинение, композиция
COMPOSURE|спокойствие, самообладание
COMPOUND|составной -u**
COMPREHEND|Постигать
COMPREHENSIVE|исчерпывающий, обширный
COMPRESS|компресс
COMPROMISE|компромисс
COMPUTER|компьютер
CON|Подставить
CONCEAL|скрывать, утаивать
CONCEALED|Скрытый
CONCEDE|уступать, допускать
CONCEIT|самомнение
CONCEITED|самодовольный, тщеславный
CONCEIVE|постигать, понимать
CONCEIVED|Задуманный
CONCENTRATE|сосредотачиваться
CONCENTRATION|концентрация, сосредоточенность
CONCEPT|концепция, понятие, идея
CONCERN|забота c-
CONCERNED|заинтересованный, озабоченный, огорченный
CONCERNING|относительно (не relatively) -ing
CONCERT|концерт
CONCESSION|концессия
CONCLUDE|завершать, заключать
CONCLUDED|завершенный, законченный (не completed) 
CONCLUSION|заключение
CONCLUSIONS|Заключения
CONCRETE|бетон, сгущать, конкретный
CONCUSSION|сотрясение (мозга)
CONDESCENDING|снисходительный -ing
CONDITION|условие
CONDUCT|вести, руководитель, проводить
CONDUCTED|Проводимый
CONDUCTOR|кондуктор
CONE|конус, шишка (еловая)
CONFER|обсуждать, совещаться; вести переговоры с
CONFERENCE|конференция, съезд
CONFESS|признавать
CONFESSED|Признанный
CONFESSION|признание, исповедь
CONFIDE|доверять, полагаться, признаваться
CONFIDENCE|доверие
CONFIDENT|уверенный
CONFIDENTIAL|конфиденциальный, доверчивый
CONFIGURATION|Конфигурация
CONFINED|Ограниченный(заключенный)
CONFINEMENT|Заключение
CONFIRM|подтверждать, утверждать
CONFIRMED|Подтвержденный
CONFLICT|конфликт, противоречить
CONFORM|соответствовать, подчиняться
CONFRONT|стоять против
CONFUSE|смущать, приводить в замешательство
CONFUSED|запутанный, смущённый 
CONFUSION|смущение
CONGRATULATE|поздравлять
CONGRATULATED|поздравил (от congratulate)
CONGRATULATIONS|поздравления (от congratulation)
CONJECTURE|догадка, предположение, предполагать
CONJURE|показывать фокусы
CONNECT|соединять
CONNECTING|Соединение -ing
CONNECTION|соединение
CONNECTIONS|Связи
CONQUER|завоевывать, завоевать
CONQUERED|Побежденный
CONQUEST|завоевание, покорение
CONSCIENCE|совесть, сознание
CONSCIENTIOUS|добросовестный
CONSCIOUS|сознающий, ощущающий
CONSCIOUSNESS|сознание, сознательность
CONSENT|разрешение
CONSENTED|Соглашался
CONSEQUENCE|следствие, вывод, значение
CONSEQUENCES|Последствия
CONSEQUENTLY|следовательно, в результате
CONSERVATIVE|консервативный, консерватор
CONSIDER|считать
CONSIDERABLE|значительный c-
CONSIDERABLY|значительно (не tremendously)
CONSIDERATE|внимательный (к другим), чуткий
CONSIDERATION|рассмотрение, соображение
CONSIDERING|Рассмотрение -ing
CONSIST|состоять
CONSISTED|Состоял
CONSISTENT|совместимый, согласующийся (не compatible)
CONSISTS|состоит (от consist)
CONSOLATION|утешение
CONSOLE|утешать
CONSPICUOUS|заметный, выдающийся c-
CONSTANT|постоянный
CONSTANTLY|постоянно
CONSTELLATION|созвездие
CONSTITUTE|назначать, учреждать
CONSTITUTION|конституция
CONSTRAINT|Ограничение
CONSTRAINTS|Ограничения
CONSTRUCT|строить, создавать
CONSTRUCTION|строительство
CONSULATE|консульство
CONSULT|советоваться
CONSULTATION|консультация, совещание
CONSUME|потреблять
CONSUMPTION|потребление, расход
CONTACT|устанавливать связь
CONTAIN|содержать, сдерживать
CONTAINING|Содержащий
CONTAINS|Содержит
CONTEMPORARY|современный
CONTEMPT|презрение (не aversion)
CONTEND|бороться, соперничать *o-
CONTENT|содержание
CONTENTED|Удовлетворенный (не satisfied)
CONTENTS|содержание, содержимое, оглавление
CONTEST|спор, соревнование, спорить
CONTEXT|контекст, ситуация
CONTINENT|континент
CONTINENTAL|континентальный
CONTINUAL|беспрестанный
CONTINUALLY|непрерывно
CONTINUATION|продолжение
CONTINUE|продолжать(ся)
CONTINUED|продолжал (от continue)
CONTINUOUS|непрерывный
CONTRACT|договор, контракт
CONTRADICT|опровергать, противоречить
CONTRARY|противоположный (не opposite)
CONTRAST|противоположность, контраст
CONTRIBUTE|делать вклад, способствовать
CONTRIBUTION|вклад
CONTRIBUTOR|сотрудник
CONTRIVANCE|изобретение, приспособление
CONTRIVED|Изобретенный
CONTROL|контроль, управление
CONVALESCE|выздоравливать
CONVENIENCE|удобство
CONVENIENCES|удобства (от convenience)
CONVENIENT|подходящий, удобный
CONVENTION|собрание, съезд
CONVENTIONAL|обычный, обусловленный
CONVERSATION|разговор, беседа
CONVERSION|превращение, обращение
CONVERT|превращать, обращать, конвертировать
CONVERTED|Преобразованный(конвертированный)
CONVEY|перевозить, передавать, сообщать
CONVEYED|Переданный
CONVICT|признать виновным, осудить
CONVICTION|осуждение, убеждение, убежденность
CONVINCE|убеждать c-
CONVINCED|убежденный
CONVINCING|убедительный
COOK|готовить, повар
COOKED|готовил (от cook)
COOL|прохладный, холодный
COOLER|холоднее (от cool)
COOLING|охлаждение -ing
COOLLY|Прохладно
COOLNESS|прохлада, хладнокровие
COOPERATIVE|кооперативный
COPE|справиться, совладать
COPIES|Копии
COPPER|медь
COPY|копия, копировать
COPYRIGHT|авторское право
CORAL|Коралл
CORD|шнур
CORDIAL|сердечный
CORE|сущность, суть
CORK|поплавок
CORN|кукуруза
CORNER|угол
CORNERS|Углы
CORRECT|исправлять, правильный
CORRECTION|исправление
CORRECTLY|правильно, верно
CORRELATION|Корреляция
CORRESPONDENCE|корреспонденция, переписка
CORRESPONDING|соответственный, соответствующий
CORRIDOR|коридор
CORRUPT|испорченный, развращенный, продажный
CORRUPTION|продажность
COSMETIC|косметический
COST|стоить, стоил
COSTUME|костюм
COSY|уютный
COTTAGE|коттедж
COTTON|хлопок, хлопчатобумажный
COUCH|кушетка
COUGH|кашель
COULD|мог, могли (бы)
COUNCIL|совет, совещание (не counsel)
COUNCILMAN|Член совета
COUNSEL|обсуждение, совет, решение, адвокат
COUNT|считать, принимать во внимание
COUNTENANCE|Самообладание(лицо)
COUNTER|прилавок, противостоять, противиться
COUNTERACT|противодействовать (не contradict)
COUNTLESS|бесчисленный
COUNTRIES|страны (от country)
COUNTRY|страна
COUNTRYSIDE|сельская местность
COUNTY|графство
COUPLE|пара
COURAGE|мужество, смелость
COURAGEOUS|смелый, отважный
COURSE|курс, блюдо
COURT|корт, двор
COURTYARD|двор
COUSIN|двоюродный брат
COUSINS|кузены 
COVE|сооружать
COVER|покрывало, крышка
COVERING|Покрытие
COW|корова
COWARD|трус
COWARDLY|трусливый, малодушный
CRAB|краб
CRACK|попытка, проба, трещина
CRACKER|печенье, хлопушка
CRACKLE|хрустеть, потрескивать
CRADLE|колыбель, убаюкивать
CRAFT|искусство, судно
CRAFTSMAN|ремесленник
CRAM|запихивать, пичкать, учить наспех, натаскивать (к экзаменам) не poke
CRANE|журавль, подъемный кран
CRANNY|скважина, трещина
CRASH|потерпеть крах, потерпеть крушение
CRASHED|Потерпел крах
CRAWFORD|Кравфорд
CRAWL|ползать (не creep)
CRAWLED|Ползал (не от слова creep)
CRAZY|безумный
CREAK|скрип, скрипеть
CREAM|сливки, крем
CREATE|создавать
CREATED|Созданный
CREATING|Создание -ing
CREATION|создание (похоже на creature)
CREATOR|творец, создатель, автор
CREATURE|творение, создание
CREATURES|Существа
CREDENTIALS|верительные грамоты, рекомендация
CREDIT|кредит
CREEP|ползать, выползать
CREEPER|вьющееся растение
CREEPING|Ползающий
CREPT|ползал 
CRESCENT|полумесяц
CREST|гребешок, хохолок, гребень (волны, горы)
CREVICE|трещина, расщелина
CREW|судовая команда, экипаж
CRICKET|крикет (спорт.)
CRIES|Крики
CRIME|преступление, преступность
CRIMINAL|преступник, уголовный
CRIMSON|алый, малиновый (не scarlet)
CRINGE|раболепствовать
CRIPPLE|калечить, уродовать (не destroy, disable)
CRISIS|кризис, перелом (в ходе болезни)
CRISP|хрустящий картофель
CRITICAL|критический
CRITICISM|критика
CRITICIZE|критиковать
CROCODILE|крокодил
CROOK|крюк, крючок, поворот
CROOKED|кривой
CROP|урожай
CROSS|пересекать
CROSSING|переход, пересечение
CROUCH|притаиться
CROUCHED|Присел
CROW|ворона
CROWD|толпа, толпиться
CROWDED|многолюдный
CROWN|корона
CRUDE|сырой, необработанный
CRUEL|жестокий, беспощадный
CRUELTY|жестокость
CRUISE|морское путешествие (c-)
CRUMB|крошка
CRUMBLE|крошить(ся)
CRUSHED|Сокрушенный
CRUST|корка, кора
CRY|кричать, восклицать
CRYING|кричащий (-ing) 
CRYSTAL|хрусталь
CUB|детеныш (зверя)
CUBIC|кубический
CUCKOO|кукушка
CUCUMBER|огурец
CUCUMBERS|огурцы (от cucumber)
CUFF|наручники, лёгкий удар
CULPRIT|обвиняемый, преступник (не accused)
CULTIVATE|обрабатывать
CULTIVATED|Выращенный
CULTIVATION|Культивирование
CUNNING|хитрость, хитрый, коварный -ing
CUP|чашка
CUPBOARD|буфет
CUPS|чашки (от cup)
CURB|сдерживать
CURDLE|свертываться (о молоке)
CURE|лекарство, лечить c-
CURIOSITY|любопытство, редкая вещь
CURIOUS|любознательный
CURIOUSLY|странно (не strangely) 
CURL|виться, завивать(ся); локон, завиток
CURLED|Вился
CURLS|Завитки
CURRANT|коринка, смородина
CURRENT|течение, ток
CURRENTLY|В настоящее время
CURSE|проклятие
CURSOR|Курсор
CURT|краткий, сжатый, грубый
CURTAIN|занавеска, занавес
CURTAINS|занавески 
CURVATURE|Искривление
CURVE|изгиб, гнуть c-
CURVED|Изогнутый
CUSHION|подушка
CUSTOM|обычай
CUSTOMARY|обычный
CUSTOMER|клиент
CUT|разрез, фасон (стрижки волос)
CUTE|изящный, прелестный
CUTTING|сокращение, урезание -ing
CYCLE|цикл, период
CYCLIST|велосипедист
CZAR|Царь c-
DAD|папа, отец
DAGGER|кинжал
DAILY|ежедневно
DAINTY|лакомство, деликатес
DAIRY|молочный магазин
DAISY|маргаритка
DALTON|Далтон
DAM|дамба, плотина
DAMAGE|повреждать, причинять ущерб
DAME|дама, пожилая женщина (не lady)
DAMP|сырой, влажный
DAN|Дэн
DANCE|танцевать
DANCED|танцевал (от dance)
DANCING|танцы -ing
DANDY|нарядный, великолепный
DANGER|опасность
DANGEROUS|опасный
DANGERS|Опасности
DANGLE|качаться, подвешивать
DARCY|Дарси
DARE|сметь, отважиться
DARED|осмелившийся 
DARING|смелость, отвага; смелый, отважный -ing
DARK|темный, печальный
DARKENED|Затемненный *a-
DARKER|Более темный
DARKNESS|темнота, мрак
DARLING|любимый, дорогой
DARN|штопать
DARTED|Брошенный (не dashed)
DARWIN|Дарвин
DASH|оттолкнуть, отбросить
DASHED|брошенный 
DATA|данные, факты
DATABASE|База данных
DATABASES|Базы данных
DATE|дата
DATES|даты (от date)
DAUGHTER|дочь
DAUGHTERS|дочери (от daughter)
DAVID|Дэвид
DAWN|рассвет, светать
DAY|день
DAYBREAK|рассвет
DAYLIGHT|дневной свет
DAYS|дни (от day)
DAYTIME|дневное время
DAZED|ошеломленный
DEAD|мертвый
DEADLOCK|тупик, безвыходное положение
DEADLY|смертельно
DEAF|глухой
DEAL|значительное количество
DEALING|раздачаv -ing
DEAN|декан
DEAR|дорогой
DEAREST|Дорогой (не darling)
DEATH|смерть
DEBATE|дебаты, спор, полемика
DEBRIS|обломки, развалины
DEBT|долг
DEBTS|долги (от debt)
DECAY|гниение, разложение
DECEIVE|обманывать
DECEIVED|обманутый 
DECEMBER|декабрь
DECENCY|приличие, благопристойность
DECENT|приличный, скромный
DECEPTION|обман, хитрость -ion
DECEPTIVE|обманчивый
DECIDE|решать
DECIDED|решил (от decide)
DECIDEDLY|определённо, точно, бесспорно (не doubtless) 
DECIMAL|десятичный, десятичная дробь
DECIPHER|расшифровывать
DECISION|решение
DECISIVE|решающий
DECK|палуба
DECLARATION|декларация
DECLARE|декларировать
DECLARED|Объявленный
DECLINE|опускаться, уменьшаться, убывать
DECLINED|Отклоненный **c-
DECORATE|украшать
DECOY|западня, приманка; заманивать в ловушку d-
DECREASE|уменьшать, уменьшить
DECREE|декрет, указ; издавать декрет; постановлять
DECREPIT|ветхий, дряхлый
DEDICATE|посвящать, посвятить
DEDUCTION|вычитание, вычет, удержание, вывод, заключение (-ion)
DEED|подвиг, дело
DEEP|глубокий
DEEPER|Глубже
DEEPLY|глубоко
DEER|олень, лань
DEFAULT|Неплатеж, невыполнение обязательств
DEFEAT|поражение
DEFEATED|побеждённый 
DEFECT|недостаток, недочет
DEFECTIVE|неисправный, недостаточный, неполноценный, дефективный
DEFENCE|оборона, защита
DEFEND|защищать, оборонять
DEFENDER|защитник, чемпион (не champion)
DEFENSE|оборона 
DEFENSIVE|оборонительный, оборона
DEFIANCE|неповиновение, пренебрежение
DEFIANT|вызывающий, дерзкий
DEFICIENCY|недостаток, дефицит -y
DEFINE|определять, устанавливать
DEFINED|Определенный
DEFINITE|определенный, точный
DEFINITELY|Определенно
DEFINITION|определение
DEFY|действовать наперекор
DEGRADE|понижать, разжаловать
DEGREE|степень, звание
DEITY|божество
DEJECTED|удрученный, угнетенный
DELAY|отсрочка
DELAYED|отложен (от delay)
DELETE|Удалить
DELIBERATE|умышленный, обдуманный
DELIBERATELY|сознательно, обдуманно 
DELICACY|деликатность, тонкость, нежность (красок); хрупкость, болезненность
DELICATE|изящный d-
DELICIOUS|восхитительный, прелестный, вкусный (d-)
DELIGHT|восхищение, восхищаться
DELIGHTED|восхищался (от delight)
DELIGHTFUL|восхитительный (не marvellous)
DELIRIUM|бред
DELIVER|доставлять, передавать
DELIVERANCE|освобождение, избавление
DELIVERED|доставил (от deliver)
DELIVERY|доставка
DELUGE|наводнение, ливень
DELUSION|заблуждение
DELVE|впадина, рытвина
DEMAND|требовать
DEMANDED|требовал (от demand)
DEMOLITION|уничтожение
DEMONSTRATE|демонстрировать
DEMONSTRATION|демонстрация
DEN|берлога, притон
DENE|долина, дюны
DENIAL|отрицание, опровержение
DENIED|Отклоненный
DENOTE|означать, обозначать
DENSE|густой, плотный (не bushy)
DENTIST|зубной врач
DENY|отрицать, отвергать
DEPART|отбывать, уезжать
DEPARTED|Отбыл
DEPARTMENT|отдел
DEPARTMENTS|отделы, отделения (от department)
DEPARTURE|отъезд, отправление
DEPEND|зависеть
DEPENDANT|иждивенец
DEPENDED|Зависел
DEPENDENT|зависимый, зависящий
DEPLORE|сожалеть
DEPLOY|развертывать
DEPLOYMENT|развертывание
DEPOSIT|взнос, вклад, залог, сдавать на хранение
DEPRESSION|уныние, депрессия (эконом.)
DEPRIVE|лишать, отбирать
DEPTH|глубина
DEPTHS|Глубины
DEPUTY|депутат, делегат
DERISIVE|насмешливый, иронический (не ironical)
DERIVED|Полученный
DES|Дес
DESCEND|спускаться
DESCENDANT|потомок
DESCENDED|Спускался
DESCENT|спуск, склон, десант, происхождение
DESCRIBE|описывать
DESCRIPTION|описание
DESERT|пустыня
DESERTED|брошенный, пустынный
DESERTER|дезертир
DESERTS|заслуги
DESERVE|заслуживать
DESERVED|заслуженный 
DESERVES|Заслуживает
DESIGN|проектировать, спроектировать
DESIGNED|предназначенный, намеренный
DESIGNER|конструктор
DESIGNS|Проекты
DESIRABLE|желательный
DESIRE|желание
DESIRED|Желательный
DESK|письменный стол
DESOLATE|покинутый, заброшенный (-e)
DESPAIR|отчаяние
DESPERATE|отчаянный, безнадежный
DESPERATELY|отчаянно 
DESPISE|презирать -e
DESPITE|несмотря на
DESSERT|десерт
DESTINATION|место назначения
DESTITUTE|(сильно) нуждающийся
DESTROY|разрушать, уничтожать
DESTROYED|Разрушенный
DESTROYER|эскадренный миноносец
DESTRUCTION|разрушение
DETACH|отделять, посылать (воен.)
DETACHED|отдельный d-
DETACHMENT|отряд
DETAIL|деталь
DETAILED|детальный, подробный
DETAIN|задерживать, удерживать
DETECT|открывать, обнаруживать d-
DETECTED|Обнаруженный
DETECTION|открытие, обнаружение
DETECTIVE|детектив(ный)
DETECTIVES|Детективы
DETENTION|задержание
DETERMINATION|решимость, определение
DETERMINE|определять, устанавливать, разрешать
DETERMINED|решительный
DETEST|питать отвращение, ненавидеть
DETRIMENTAL|приносящий ущерб (не destructive)
DEVELOP|развивать
DEVELOPED|развил (от develop)
DEVELOPER|развивающийся (о человеке) 
DEVELOPMENT|развитие
DEVICE|прибор, схема, проект, прием, устройство
DEVIL|дьявол, сатана
DEVOTE|посвящать
DEVOTED|преданный
DEVOTION|преданность
DEVOUR|пожирать
DEW|роса
DEXTERITY|проворство, ловкость
DIAGRAM|диаграмма, схема
DIAL|набирать номер
DIALECT|Диалект
DIALOGUE|диалог
DIAMETER|диаметр
DIAMOND|алмаз, бриллиант
DIANA|Диана
DIARY|дневник
DICK|Дик
DICTIONARY|словарь
DICTUM|изречение, поговорка (не byword)
DID|делал, действовал (от do)
DIE|штамповать, чеканить
DIED|умер, умерший (от die)
DIET|диета
DIFFER|различать
DIFFERENCE|разница, различие
DIFFERENCES|Различия
DIFFERENT|другой, отличный от
DIFFERENTLY|По-другому
DIFFERS|Отличается
DIFFICULT|трудный
DIFFICULTY|препятствие, затруднение
DIG|копать
DIGEST|переваривать, усваивать, краткое изложение
DIGESTION|пищеварение
DIGGING|Рытье -ing
DIGNIFIED|достойный
DIGNITY|достоинство
DILIGENCE|прилежание
DIM|тусклый, неясный, слабый (о зрении), туманный, смутный
DIME|дайм (10 центов)
DIMLY|смутно (не vague) 
DIN|шум, долбить
DINE|обедать
DINING|обеденный
DINNER|обед
DIP|погружать
DIPLOMA|диплом, свидетельство
DIPPER|черпак, ковш
DIRECT|прямой, руководить
DIRECTED|Направленный
DIRECTION|направление
DIRECTIONS|Руководства(направления)
DIRECTLY|прямо, немедленно (d-)
DIRECTOR|режиссер
DIRECTORY|справочник
DIRT|грязь
DIRTY|грязный
DISABLE|делать непригодным (не destroy)
DISABLED|искалеченный, выведенный из строя
DISADVANTAGE|неудобство
DISAGREEABLE|неприятный
DISAPPEAR|исчезать, исчезнуть
DISAPPEARANCE|исчезновение 
DISAPPEARED|изчезнувший 
DISAPPEARING|Исчезновение -ing
DISAPPOINT|разочаровывать
DISAPPOINTED|разочарованный (от disappoint)
DISAPPOINTING|печальный, неутешительный -ing
DISAPPOINTMENT|разочарование
DISAPPROVAL|неодобрение
DISARM|обезоруживать, разоружать(ся)
DISARMAMENT|разоружение
DISASTER|бедствие, несчастье
DISASTROUS|бедственный
DISBELIEF|недоверие
DISC|диск
DISCERN|различать, видеть
DISCHARGE|разряжать
DISCIPLINE|дисциплина, обучение
DISCONNECTED|разъединенный
DISCONTENT|недовольство (не unpleasure)
DISCONTENTED|недовольный (не disagreeable)
DISCOURAGE|обескураживать
DISCOVER|открывать, обнаруживать
DISCOVERED|обнаруженный 
DISCOVERY|открытие
DISCREET|осторожный, сдержанный
DISCRETION|свобода действий; свободный выбор
DISCUSS|обсуждать
DISCUSSED|обсуждал (от discuss)
DISCUSSING|обсуждающий, обсуждение (от discuss)
DISCUSSION|беседа
DISDAIN|презирать, пренебрегать; презрение, пренебрежение (не neglect)
DISEASE|болезнь *i-
DISGRACE|позор, немилость
DISGRACEFUL|позорный
DISGUISE|переодеваться, маскироваться, скрывать; маскировка
DISGUISED|замаскированный 
DISGUISES|Маскировки
DISGUST|отвращение, вызывать отвращение
DISH|блюдо
DISHEVELLED|растрепанный, взъерошенный
DISHONEST|нечестный
DISK|Диск
DISLIKE|нелюбовь, неприязнь; не любить
DISMAL|мрачный, унылый (не gloomy, dreary)
DISMAY|ужас d-
DISMISS|увольнять
DISMISSED|уволенный 
DISMOUNT|спешиваться
DISORDER|беспорядок
DISPERSE|рассеиваться
DISPLAY|показ, выставка
DISPLAYED|Показанный
DISPLEASED|недовольный
DISPLEASURE|неудовольствие, недовольство, досада
DISPOSAL|вручение, право распоряжаться
DISPOSE|располагать
DISPOSED|склонный, расположенный, имеющийся под рукой (не inclined) 
DISPOSITION|характер
DISPUTE|диспут, полемика, обсуждать
DISREGARD|пренебрегать, пренебрежение
DISSOLVE|растворять
DISSOLVED|Распущенный
DISTANCE|расстояние
DISTANT|дальний, далекий
DISTINCT|отдельный (не separate, detached)
DISTINCTION|различие
DISTINCTLY|отчетливо
DISTINGUISH|отличать, различать, разделять
DISTINGUISHED|выдающийся, почетный
DISTRACT|отвлекать
DISTRACTED|Отвлеченный
DISTRESS|горе, нужда; огорчать, расстраивать d-
DISTRESSED|Обеспокоенный
DISTRIBUTE|распределять, распространять
DISTRIBUTION|распределение
DISTRICT|район
DISTRUST|недоверие, не доверять
DISTURB|нарушать, беспокоить d-
DISTURBANCE|нарушение
DISTURBED|взбудораженный *i- 
DITCH|канава
DITTY|песенка
DIVE|нырять
DIVED|Нырнул
DIVER|водолаз
DIVERSE|разный, различный (не various)
DIVIDE|делить, отделять
DIVIDED|Разделенный
DIVINE|божественный
DIVING|ныряние
DIVISION|деление
DIZZY|головокружительный
DO|делать, действовать, вспомогательный глагол
DOCK|док, пристань
DOCTOR|доктор, врач
DOCTRINE|Доктрина
DOCUMENT|документ
DOCUMENTATION|Документация
DODGE|уловка, хитрость (не trick)
DOER|исполнитель
DOES|делать, действовать, вспомогательный глагол (от do)
DOG|собака
DOING|делающий (от do)
DOLL|кукла
DOLLAR|доллар
DOLLARS|доллары (от dollar)
DOLLS|Куклы
DOMAIN|Область
DOME|купол
DOMESTIC|домашний, внутренний
DOMESTICATED|Одомашненный
DOMINION|владычество, владение, доминион
DONATION|денежное пожертвование
DONE|сделанный (от do)
DONKEY|осел
DOOM|обрекать
DOOR|дверь
DOORWAY|дверной проем 
DORMITORY|спальня
DOROTHY|Дороти
DOS|ДОС
DOSE|доза, дозировать
DOT|точка
DOTS|Точки
DOUBLE|двойной, на двоих
DOUBLOONS|Дублоны
DOUBLY|вдвое
DOUBT|сомнение, сомневаться
DOUBTED|Подвергнутый сомнению
DOUBTFUL|сомневающийся (полон сомнений)
DOUBTLESS|несомненно
DOUBTS|Сомнения
DOUGH|тесто d-
DOVE|голубь
DOWN|внизу, вниз
DOWNSTAIRS|вниз, внизу, на нижнем этаже
DOWNWARD|вниз, книзу
DOWNY|пушистый
DOZE|дремать
DOZEN|дюжина
DR|Доктор
DRAFT|чертеж, проект
DRAG|тащить d-
DRAGGED|Тянул
DRAGON|дракон 
DRAIN|вытекание
DRAMATIC|драматический
DRANK|(вы)пил (от drink)
DRAUGHT|сквозняк, набросок, черновик
DRAW|рисовать
DRAWER|чертежник
DRAWERS|кальсоны
DRAWING|протаскивание, вытягивание, рисование, чертеж
DRAWN|нарисованный (от draw)
DREAD|страшиться, страх
DREADFUL|ужасный (не terrible, horrible)
DREADFULLY|Ужасно
DREAM|мечтать, видеть сны
DREAMS|мечты 
DREAMT|мечтал (от dream)
DREARY|мрачный, унылый, скучный (не gloomy)
DRESS|платье, одеваться
DRESSED|одетый
DRESSING|приправа
DRESSMAKER|портниха
DREW|рисовал (от draw)
DRIED|сушеный
DRIFT|сносить, плыть по течению
DRILL|дрель, тренировать
DRINK|напиток, пить
DRINKS|напитки (от drink)
DRIP|капать
DRIVE|водить машину, ехать на машине
DRIVER|водитель, шофер
DRIVEWAY|проезд 
DRIVING|езда, вождение, движущий
DROOP|поникать
DROOPING|Свисающий -ing
DROP|капля, падать, ронять
DROPPED|потерянный, пролитый (не spoiled) 
DROPPING|сбрасывающий
DROPS|Снижения(капли)
DROVE|водил машину, ехал на машине (от drive)
DROWN|тонуть, топить(ся), заглушать
DROWSY|сонный, дремлющий (не asleep, sleepy)
DRUG|лекарство, наркотик
DRUGSTORE|аптека d-
DRUM|барабан
DRUNK|выпитый, пьяный (от drink)
DRY|сухой
DUBIOUS|сомнительный
DUCHESS|герцогиня
DUCK|утка
DUCKED|Увернулся
DUCKS|Утки
DUDLEY|Дадли
DUE|должный, обязанный
DUES|сборы, взносы
DUG|сиська, вымя 
DUKE|герцог
DULL|скучный
DULY|должным образом
DUMB|немой, бессловесный, бестолковый (амер.)
DUMMY|манекен, макет
DUMP|разгружать
DUNGEON|Темница
DUPLICATE|дубликат, копия
DURABLE|прочный
DURATION|продолжительность
DURING|во время
DUSK|сумеречный, неясный, сумерки
DUST|пыль, вытирать пыль
DUSTER|тряпка, щетка
DUSTY|пыльный
DUTY|долг, обязанность, пошлина
DWARF|карлик, гном (миф.) (не gnome)
DWELL|жить
DWELLING|жилье -ing
DWIGHT|Дуайт
DYE|красить, краска
DYED|крашенный (от dye)
DYING|погибающий
DYSENTERY|дизентерия
EACH|каждый
EAGER|нетерпеливый
EAGERLY|охотно (не willing)
EAGERNESS|пыл, рвение, желание
EAGLE|орел
EAR|ухо
EARL|граф 
EARLIER|Ранее
EARLIEST|Самый ранний
EARLY|рано
EARN|зарабатывать
EARNEST|серьезный e-
EARNESTLY|Искренне (не sincerely)
EARNESTNESS|Серьезность (не seriousness)
EARTH|земля
EARTHQUAKE|землетрясение
EASE|покой, непринужденность e-
EASEL|мольберт
EASIER|Более легкий
EASILY|легко
EAST|восток, восточный
EASTER|пасха
EASTERN|восточный
EASY|легкий, простой
EAT|есть (принимать пищу)
EATEN|eat (3 форма)
EATER|едок
EATING|прием пищи, еда (-ing)
EBB|отлив, убывать
ECHO|эхо, отголосок
ECONOMICAL|бережливый, экономный
EDGE|край, точить
EDIBLE|съедобный
EDINBURGH|Эдинбург
EDIT|редактировать
EDITION|издание
EDITOR|редактор
EDITORIAL|редакционный, передовая статья (амер.)
EDMUND|Эдмунд
EDUCATED|образованный ed-
EDUCATION|образование
EDUCATIONAL|образовательный, воспитательный
EDWARD|Эдвард
EERIE|Жуткий *e-
EFFECT|действие, влияние
EFFECTED|Произведенный (не produced) *f-
EFFECTIVE|действующий, успешный
EFFECTS|Эффекты
EFFECTUALLY|Целесообразно
EFFICIENCY|эффективность
EFFICIENT|эффективный
EFFORT|усилие, напряжение
EGG|яйцо
EGGS|яйца (от egg)
EGYPT|Египет
EIGHT|восемь
EIGHTEEN|восемнадцать
EIGHTH|восьмой
EIGHTY|восемьдесят
EITHER|или
EL|Эль-
ELABORATE|тщательно разработанный, подробный
ELAPSE|проходить (о времени)
ELASTIC|эластичный, упругий, резинка
ELATED|окрыленный
ELBOW|локоть
ELBOWS|Локти
ELDER|старший
ELDERLY|пожилой
ELDEST|(самый) старший
ELECT|выбирать **e**
ELECTION|избрание, выборы
ELECTRIC|электрический
ELECTRICITY|электричество
ELECTRONIC|электронный
ELEGANT|изящный
ELEMENT|элемент, стихия
ELEMENTARY|элементарный
ELEMENTS|Элементы
ELEPHANT|слон
ELEVATE|поднимать, возвышать
ELEVATED|Поднятый
ELEVATION|Возвышение
ELEVATOR|лифт
ELEVEN|одиннадцать
ELF|Эльф
ELIGIBLE|подходящий (не suitable)
ELIMINATE|исключать, уничтожать, ликвидировать
ELINOR|Элеонор
ELIZA|Элиза
ELIZABETH|Элизабет
ELLIOT|Эллиот
ELOISE|Элоиза
ELONGATED|Удлиненный
ELSE|еще, кроме
ELSEWHERE|В другом месте
ELTON|Эльтон
EMBARK|садиться на корабль
EMBARRASS|смущать
EMBARRASSMENT|Затруднение
EMBEDDED|Вложенный
EMBRACE|обнимать, включать
EMBROIDERY|вышивка
EMERALD|изумруд
EMERGE|появляться, выясняться, возникать (не appear)
EMERGED|Появился
EMERGENCY|крайняя необходимость e-
EMINENT|выдающийся
EMMA|Эмма
EMOTION|возбуждение
EMOTIONAL|эмоциональный
EMOTIONS|Эмоции
EMPEROR|император
EMPHASIS|подчеркивание, ударение, выразительность
EMPIRE|империя, господство
EMPLOY|держать на работе, нанимать
EMPLOYED|Используемый
EMPLOYEE|служащий, работник
EMPLOYER|наниматель
EMPLOYMENT|служба, занятие (не occupation, profession)
EMPTY|пустой
EMULATION|соревнование
ENABLE|давать возможность, делать возможным
ENABLED|Позволил
ENAMEL|эмаль, глазурь
ENCAMPMENT|лагерь
ENCLOSE|окружать
ENCLOSED|Приложенный (не embedded, attached)
ENCOUNTER|встретить, сталкиваться
ENCOURAGE|ободрять, поощрять, подстрекать
ENCOURAGED|Поощренный
ENCOURAGEMENT|ободрение
ENCYCLOPEDIA|энциклопедия
END|конец
ENDANGER|подвергать опасности
ENDEAVOUR|попытка
ENDED|Законченный
ENDING|окончание, завершение -ing
ENDLESS|бесконечный
ENDLESSLY|нескончаемо
ENDURANCE|выносливость, терпение (не tolerance)
ENDURE|Вынести
ENEMIES|Враги
ENEMY|враг, противник
ENERGY|энергия, сила
ENFORCE|принуждать, навязывать, проводить в жизнь
ENGAGE|нанимать, занимать, вовлекать (не employ)
ENGAGED|занятый, помолвленный (от engage)
ENGAGEMENT|занятие *n-
ENGINE|двигатель, мотор, машина
ENGINEDRIVER|машинист
ENGINEER|инженер
ENGINEERING|техника, машиностроение, махинации
ENGLAND|Англия
ENGLISH|английский язык, английский
ENHANCED|Увеличенный
ENHANCEMENTS|Повышения
ENJOY|любить, получать удовольствие
ENJOYED|получил удовольствие (от enjoy)
ENJOYMENT|удовольствие, наслаждение, обладание
ENLARGE|увеличивать, расширять, распространяться **l****
ENLIGHTEN|просвещать
ENORMOUS|громадный, ужасный
ENORMOUSLY|чрезвычайно
ENOUGH|достаточный
ENQUIRED|Спрашивал e-
ENSLAVE|порабощать
ENSUED|Последовал
ENSURE|обеспечивать, гарантировать
ENTANGLED|запутанный
ENTER|входить, поступать (enter)
ENTERED|поступил (от enter)
ENTERING|вступление e-
ENTERPRISE|предприятие, предприимчивость
ENTERPRISING|предприимчивый
ENTERTAIN|развлекать, развлечь
ENTERTAINED|Развлекал
ENTERTAINMENT|развлечение
ENTHUSIASM|энтузиазм, восторг
ENTHUSIASTIC|восторженный
ENTIRE|полный, совершенный
ENTIRELY|совершенно, полностью, исключительно
ENTITLED|Имеющий право
ENTRANCE|вход
ENTREATY|мольба
ENTRY|вход
ENUMERATE|перечислять
ENVELOPE|конверт
ENVIOUS|завистливый (не jealous)
ENVIRONMENT|окружающая среда
ENVY|зависть, завидовать
EPIDEMIC|эпидемический, эпидемия
EPISODE|эпизод
EQUAL|равный
EQUALITY|равенство, равноправие
EQUALLY|поровну, одинаково, в равной степени
EQUATOR|экватор
EQUIPMENT|снаряжение, оборудование
ER|отделение (служба) экстренной медицинской помощи (Emergency Room) 
ERA|эра
ERASE|стирать (резинкой)
ERE|До, перед, прежде чем; скорее чем
ERECT|строить (не build)
ERNEST|Эрнест
ERNIE|Ерни
ERR|Допустить ошибку
ERRAND|поручение
ERRING|грешный, заблудший -ing
ERRONEOUS|ошибочный
ERROR|ошибка
ERRORS|Ошибки
ESCAPE|избежать, избегать
ESCORT|охрана (не guards)
ESPECIALLY|особенно
ESSAY|очерк
ESSENCE|сущность
ESSENTIAL|обязательный, существенный, важный e-
ESTABLISH|учреждать, создавать, утверждать
ESTABLISHED|установленный
ESTABLISHMENT|установление, учреждение, положение
ESTATE|поместье, имущество, сословие
ESTEEM|уважать, почитать, уважение (не regard)
ESTIMATE|оценка, проект, оценивать
ESTIMATED|предполагаемый
ET|И
ETC|И т.д
ETERNAL|вечный (не forever)
ETHEL|Етел
EUGENE|Юджин
EUROPE|Европа
EUROPEAN|европейский
EVALUATION|оценка (не estimation)
EVAPORATE|испаряться, выпаривать
EVEN|даже
EVENING|вечер
EVENINGS|вечерние (спектакли) e-
EVENT|событие
EVENTFUL|полный событий, знаменательный
EVENTS|События
EVENTUALLY|в конечном счете, в конце концов
EVER|когда-либо 
EVERY|каждый
EVERYBODY|каждый, всякий, все
EVERYDAY|повседневный
EVERYONE|все, каждый, всякий
EVERYTHING|все
EVERYWHERE|всюду, везде
EVIDENCE|доказательство e-
EVIDENT|очевидный, ясный
EVIDENTLY|очевидно
EVIL|зло, злой
EVOLUTION|Развитие
EXACT|точный
EXACTLY|точно, именно
EXAM|экзамен
EXAMINATION|экзамен
EXAMINE|рассматривать, рассмотреть
EXAMPLE|пример, образец (не pattern)
EXAMPLES|Примеры
EXAMS|экзамены (от exam)
EXASPERATION|раздражение, ожесточение
EXCAVATOR|экскаватор
EXCEED|превышать, превосходить
EXCEEDINGLY|чрезвычайно
EXCELLENT|превосходный, отличный
EXCEPT|исключая, кроме
EXCEPTING|за исключением -ing
EXCEPTION|исключение
EXCESS|избыток
EXCESSIVELY|Чрезмерно
EXCHANGE|обмен, обменивать
EXCHANGED|обменивал (от exchange)
EXCITE|возбуждать, волновать
EXCITED|взволнованный, возбуждённый
EXCITEDLY|Взволнованно (не thrilling)
EXCITEMENT|возбуждение
EXCITING|волнующий, великолепный
EXCLAIM|восклицать
EXCLAMATION|восклицание
EXCLUDE|исключать
EXCLUSIVE|исключительный, недоступный
EXCLUSIVELY|исключительно ***l-
EXCURSION|экскурсия
EXCUSE|извинять
EXECUTE|выполнять e-
EXECUTED|Выполненный
EXECUTION|выполнение
EXERCISE|упражнение
EXERT|напрягать(силы)
EXERTION|напряжение, усилие
EXHAUST|исчерпывать, истощать, выхлоп (тех.)
EXHAUSTED|изнуренный
EXHIBIT|экспонат, показывать
EXHIBITED|Показанный (не displayed)
EXHIBITION|выставка
EXIST|существовать, жить
EXISTENCE|существование
EXISTING|Существующий -ing
EXISTS|Существует
EXIT|выход, выезд
EXPANDED|Расширенный (не extended)
EXPANSION|расширение, распространение **pa-
EXPECT|ожидать
EXPECTATION|ожидание
EXPECTATIONS|ожидания (от expectation)
EXPECTED|предполагаемый, ожидаемый
EXPECTING|ожидающий (от expect)
EXPEDITION|экспедиция
EXPEL|изгонять, исключать
EXPELLED|Удаленный
EXPENSE|расход
EXPENSIVE|дорогой
EXPERIENCE|опыт
EXPERIENCED|опытный
EXPERIMENT|эксперимент
EXPERIMENTAL|экспериментальный
EXPERIMENTS|Эксперименты
EXPERT|эксперт
EXPLAIN|объяснять
EXPLAINED|объяснил (от explain)
EXPLANATION|объяснение
EXPLICIT|ясный  e-
EXPLODE|взрывать, подрывать
EXPLOIT|эксплуатировать
EXPLORATION|исследование
EXPLORE|исследовать
EXPLOSION|взрыв, вспышка
EXPLOSIVE|взрывчатый, взрывчатое вещество -ve
EXPORT|экспорт, экспортировать
EXPOSE|выставлять, подвергать, разоблачать
EXPOSED|Выставленный(подвергнутый)
EXPOSURE|Подвергание
EXPRESS|экспресс, выражать
EXPRESSING|выраженный -ing
EXPRESSION|выразительность, выражение
EXPRESSIVE|выразительный
EXPULSION|изгнание (не dejection)
EXQUISITE|изысканный
EXTEND|продлевать, растягивать
EXTENDED|растянутый
EXTENDING|Распространение(продление)
EXTENSION|расширение
EXTENSIVE|обширный
EXTENT|протяжение
EXTERIOR|внешний, внешность, внешний вид
EXTERNAL|наружный
EXTINCT|потухший (о вулкане), вымерший
EXTRA|сверх (не above)
EXTRACT|удалять, извлекать; экстракт, выдержка (из книги)
EXTRAORDINARY|необычный
EXTREME|чрезвычайный, крайность
EXTREMELY|крайне
EXTREMITY|конец, край, крайность, конечности
EYE|глаз
EYEBROW|бровь
EYEBROWS|брови 
FABLE|басня, сюжет
FACE|лицо
FACES|выходит, стоит лицом (от face)
FACILITATE|облегчать
FACILITY|легкость, способность, умение
FACING|сидящий лицом (от face)
FACT|сущность, факт
FADE|увядать
FADED|Исчез
FAIL|недоставать, не хватать;  обмануть ожидания
FAILED|потерпел неудачу, не удалось (от fail)
FAILING|Неудача -ing
FAILURE|неудача
FAINT|слабый
FAINTEST|малейший (от faint)
FAINTLY|слабо 
FAIR|любезно, хорошо, справедливый
FAIRFAX|Фаирфакс
FAIRLY|довольно (не rather)
FAIRY|волшебный
FAITH|вера
FAITHFUL|верный
FAITHFULLY|Искренне
FAITHLESS|ненадежный
FAKE|подделка 
FALCON|сокол
FALL|падать
FALLEN|упавший 
FALLING|падение
FALSE|ложный
FAME|слава, известность
FAMILIAR|близкий (f-)
FAMILY|семья
FAMINE|голод *a- (не hanger)
FAMOUS|известный
FAN|болельщик, поклонник
FANCIED|Представлял себе
FANCY|воображать, представлять себе
FANG|клык, корень зуба, зубец
FANGS|Клыки
FANNY|Фанни
FANTASTIC|фантастический
FANTASY|воображение
FAR|далеко
FAREWELL|прощание; прощайте! до свидания!
FARM|ферма
FARMER|фермер
FARRIER|Кузнец
FARTHER|дальше
FASCINATED|очаровал (от fascinate)
FASHION|мода
FASHIONABLE|модный
FASHIONED|Вылепленный
FAST|спешащий, сильно, быстро (fast)
FASTEN|прикреплять f-
FASTENED|Закрепленный (не attached)
FASTER|быстрее
FAT|жирный
FATAL|фатальный
FATE|судьба
FATHER|папа
FATIGUE|усталость, утомлять(ся)
FATTY|жирный 
FAUCET|водопроводный кран, вентиль
FAULT|вина, недостаток, ошибка
FAULTS|Ошибки f-
FAVOR|Польза(покровительство)
FAVORITE|любимый 
FAVOUR|одолжение, услуга, польза
FAVOURABLE|благоприятный
FAVOURITE|любимый
FEAR|страх, опасение, бояться, опасаться
FEARFUL|страшный
FEASIBLE|осуществимый
FEAST|пир (f-)
FEAT|подвиг, ловкость, искусство
FEATHER|предмет гордости, достижение
FEATHERS|перья 
FEATURE|особенность, характерная черта
FEATURES|Особенности
FEBRUARY|февраль
FED|Кормивший(питаемый)
FEE|гонорар, платить гонорар
FEEBLE|слабый, бледный
FEED|кормить
FEEDING|питание f-
FEEL|чувствовать
FEELING|чувство, чувствующий (от feel)
FEELINGS|страсти (от feeling)
FEELS|Чувства
FEET|ноги, ступни
FELL|упал (от fall)
FELLOW|человек, парень, приятель
FELT|чувствовал (от feel)
FEMALE|женщина, самка
FEMALES|Женщины
FEMININE|женский, женского рода (грам.)
FENCE|забор
FENCING|ограждение -ing
FERAL|Дикий (не от слова wild)
FERMENT|закваска, фермент; бродить (о вине, варенье)
FEROCIOUS|дикий
FEROCITY|свирепость
FERRY|перевоз f-
FERTILE|плодородный
FERTILISED|Оплодотворенный
FERTILITY|Изобилие (не abundance)
FERTILIZER|удобрение
FESTIVAL|праздник, фестиваль
FETCH|приносить f-
FETCHED|принесённый, достанный 
FEVER|жар, лихорадка
FEW|мало
FICKLE|непостоянный, изменчивый
FIDDLESTICKS|вздор
FIELD|поле
FIEND|дьявол, злой дух (не devil)
FIERCE|свирепый
FIERY|Пламенный
FIFTEEN|пятнадцать
FIFTEENTH|пятнадцатый
FIFTH|пятый
FIFTY|пятьдесят
FIG|Рис.
FIGHT|бороться, бой
FIGHTING|бой, сражение
FIGURE|фигура
FIGURED|Изображенный
FILAMENT|Нить
FILCH|Украсть (не steal)
FILE|картотека
FILES|Файлы
FILL|заполнить, наполнить
FILLING|заполнение, наполнение
FILM|фотопленка, фильм
FILTER|фильтр; фильтровать, просачиваться
FIN|плавник
FINAL|окончательный
FINALIZE|завершать f-
FINALLY|в конце концов
FINANCIAL|финансовый
FIND|найти, находить
FINDING|находка, открытие, решение
FINDS|Находит
FINE|прекрасно, прекрасный
FINED|штрафовал, оштрафованный (от fine)
FINEST|Самый прекрасный
FINGER|палец
FINISH|кончать(ся), заканчивать(ся), конец, финиш
FINISHED|закончил (от finish)
FINISHING|завершение
FIR|пихта, ель
FIRE|огонь, пожар
FIREPLACE|Камин
FIRES|Огни(пожары)
FIREWOOD|дрова
FIREWORKS|фейерверк
FIRING|Увольнение(обстрел) -ing
FIRM|фирма, твердый, твердо, крепко
FIRMLY|твердо, решительно
FIRST|первый
FISH|рыба
FISHERMAN|рыбак
FISHING|рыбная ловля
FISHY|подозрительный, сомнительный
FIST|кулак
FIT|подходить, соответствовать, устраивать
FITNESS|годность
FITS|подходит (от fit)
FITTING|примерка
FIVE|пять
FIX|починить, наладить, назначить
FIXED|назначил (от fix)
FIXES|Устанавливает
FLABBERGASTED|поражен, изумлен
FLAG|флаг
FLAKES|хлопья
FLAME|пламя (не blaze)
FLAMES|Огонь
FLAMING|Пылающий -ing
FLANK|фланг
FLANNEL|фланель
FLAP|развеваться, взмахивать (крыльями); взмах (крыльев), клапан
FLARE|вспыхивать; вспышка, осветительная ракета (не flash)
FLASH|вспышка, сверкать
FLASHLIGHT|карманный фонарь 
FLASHLIGHTS|Прожектора
FLASK|фляжка
FLAT|квартира, плоский
FLATTER|льстить
FLATTERING|льстивый, лестный
FLAVOUR|вкус, аромат
FLAW|изъян, недостаток (не lack)
FLAX|лен, льняное полотно
FLEA|блоха
FLED|убегал, спасался бегством 
FLEE|бежать
FLEET|флот
FLESH|тело, плоть, мясо
FLEW|летал (от fly)
FLEXIBLE|гибкий
FLIGHT|полет
FLINCH|отступать, вздрагивать
FLING|бросать(ся), швырять(ся)
FLINT|Кремень
FLOAT|плавать, поплавок
FLOCK|стадо, стая
FLOOD|наводнение
FLOOR|пол, этаж; одолеть, смутить
FLOORED|поставил в тупик, сразил (от floor)
FLORA|Флора
FLOUR|мука
FLOURISH|процветать, размахивать; росчерк
FLOURISHING|цветущий
FLOW|течение, поток, разливаться, течь
FLOWER|цветок
FLOWERBED|клумба
FLOWERY|цветистый
FLOWING|течение f-
FLU|грипп
FLUENTLY|бегло, гладко
FLUID|жидкий, жидкость
FLUNG|бросал, швырял (не threw) 
FLURRY|будоражить
FLUSH|(по)краснеть f-
FLUTTER|махать
FLY|летать
FLYING|летающий, летный (от fly)
FOAL|жеребенок
FOAM|пена
FOCUS|фокусировать
FODDER|фураж, корм
FOE|враг
FOG|туман
FOGGY|туманный
FOLD|складывать, сгибать, скрещивать (руки); складка
FOLDED|складчатый (не crease) 
FOLDER|папка (для дел), брошюра (амер.)
FOLDING|складной -ing
FOLIAGE|листва
FOLK|народная
FOLKS|Люди
FOLLOW|следовать
FOLLOWING|следующий -ing
FOLLOWS|Следует
FOLLY|глупость
FOND|нежный
FOOD|пища (не meal)
FOOL|дурак, глупец
FOOLISH|глупый
FOOT|нога, фут
FOOTBALL|футбол
FOOTPRINT|След
FOOTPRINTS|следы 
FOOTSTEP|звук шагов, след ноги
FOR|для, за, на
FORBES|Форбес
FORBID|запрещать
FORBIDDEN|Запрещенным
FORCE|сила
FORCED|принудительный, принужденный
FORCIBLE|насильственный, убедительный
FORD|брод, переходить вброд (не wade)
FORE|передний
FOREGOING|Предшествующий (не preceding) -ing
FOREGROUND|передний план
FOREHEAD|лоб
FOREIGN|иностранный
FOREIGNER|иностранец
FOREMAN|мастер, старший рабочий, техник, прораб
FOREMOST|передовой f-
FOREPAWS|Передние лапы
FORESIGHT|предвидение, предусмотрительность
FOREST|лес
FORESTER|Лесник
FORESTS|Леса
FOREVER|вечно 
FOREWORD|предисловие
FORGE|выдумывать
FORGERY|подделка, подлог
FORGET|забыть
FORGETFUL|забывчивый
FORGIVE|прощать
FORGOT|забыл (от forget)
FORGOTTEN|забытый (от forget)
FORK|вилка
FORM|бланк, форма, формировать
FORMAL|официальный, формальный
FORMALLY|формально
FORMATION|образование, структура, формирование
FORMED|сформировавшийся, организованный
FORMER|бывший
FORMERLY|прежде, некогда
FORMIDABLE|внушительный (не tremendous)
FORMING|Формирование
FORMS|формы (от form)
FORMULA|формула
FORT|Форт
FORTH|вперед, впредь, далее (f-)
FORTHWITH|тотчас, немедленно f-
FORTITUDE|стойкость, мужество
FORTNIGHT|две недели
FORTRESS|крепость
FORTUNATE|счастливый
FORTUNATELY|к счастью
FORTUNE|удача, счастье
FORTUNES|Благосостояния (не welfares)
FORTY|сорок
FORWARD|передовой, вперед, впредь
FOSSIL|ископаемое
FOSTER|воспитывать
FOUGHT|сражался 
FOUL|загрязненный, грязный, бесчестный
FOUND|нашел, найденный (от find)
FOUNDATION|основание
FOUNTAIN|источник, фонтан
FOUR|четыре
FOURTEEN|четырнадцать
FOURTEENTH|четырнадцатый
FOURTH|четвертый
FOWL|птица (домашняя)
FOWLS|Домашние птицы
FOX|лиса
FRACTION|дробь, частица f-
FRACTURE|перелом, излом; ломать
FRAGILE|хрупкий
FRAGMENT|отрывок, обрывок
FRAIL|хрупкий, хилый
FRAME|оправа, рамка
FRAMES|оправы, рамки (от frame)
FRAMEWORK|каркас
FRANCE|Франция
FRANK|искренний, откровенный, открытый
FRANKLY|откровенно
FRANTIC|неистовый ******c
FRANTICALLY|неистово 
FRANZ|Франз
FRAUD|обман, фальшивка
FRAY|шумная ссора, обтрепываться
FREAKISH|капризный, причудливый
FREE|свободный
FREEDOM|свобода f-
FREELY|свободно
FREEMAN|полноправный гражданин 
FREEZE|замерзать
FREEZING|замерзание
FREIGHT|груз, грузовой
FRENCH|французский
FREQUENT|частый
FREQUENTLY|часто
FRESH|свежий, бодрый
FRIDAY|пятница
FRIED|жареный
FRIEND|друг
FRIENDLY|дружеский, дружелюбный
FRIENDS|друзья (от friend)
FRIENDSHIP|дружба -ship
FRIGHT|испуг
FRIGHTEN|пугать
FRIGHTFUL|страшный, ужасный
FRINGE|бахрома, край
FRITTER|пончик, крошить
FRO|обратно 
FROG|лягушка
FROLIC|веселиться, проказничать
FROM|от, из
FRONT|перед, передняя сторона, фронт
FRONTIER|граница *r-
FROST|мороз
FROSTY|морозный
FROWN|нахмуриться, недовольное выражение лица
FRUIT|фрукты
FRUITLESS|бесплодный
FRUSTRATION|расстройство
FRY|(за)жарить
FUDGE|глупость, чушь
FUEL|топливо, горючее
FUGITIVE|беглый, мимолетный, беглец
FULFIL|выполнить
FULL|полный
FULLY|вполне, полностью f-
FUN|шутка, веселье
FUNCTION|функция, торжество
FUNCTIONS|Функции
FUND|фонд
FUNERAL|похороны, похоронный
FUNNEL|воронка, труба (паровоза, парохода)
FUNNY|смешной, забавный
FUR|мех, шкура
FURIOUS|взбешенный, бешеный, неистовый
FURNACE|печь, топка, горн
FURNISH|снабжать, меблировать, обставлять
FURNISHED|снаряженный, оборудованный, экипированный 
FURNITURE|мебель
FURROW|борозда, колея
FURRY|пушистый (не downy)
FURS|меха (от fur)
FURTHER|дальнейший, дополнительный (*u*****)
FURTHERMORE|кроме того
FURY|неистовство
FUSE|плавить(ся), сплавлять(ся), перегорать
FUSS|суета; суетиться, беспокоиться, хлопотать f- (не stir)
FUTILE|бесполезный, тщетный, пустой (о человеке)
FUTURE|будущее
GAG|затычка, кляп
GAILY|весело, оживленно (g первая буква)
GAIN|прибыль
GAINED|Полученный
GALACTIC|Галактический
GALAXY|Галактика
GALE|шторм
GALLANT|доблестный, отважный, смелый, храбрый (g-)
GALLERY|галерея
GAME|игра
GAMES|игры (от game)
GANG|шайка, банда
GANGSTER|бандит, гангстер
GAP|брешь
GARAGE|гараж
GARBAGE|мусор
GARDEN|сад
GARDENER|садовник
GARDENING|садоводство -ing
GARGLING|полоскающий (от gargle)
GARLIC|чеснок
GARMENT|одежда, одеяние g-
GARMENTS|Предметы одежды
GARRET|мансарда, чердак
GARRISON|гарнизон, ставить гарнизон
GAS|газ
GASOLINE|газолин, бензин (амер.)
GASP|задыхаться (не pant)
GASPED|Задыхался (не от слова pant)
GATE|ворота, проход
GATES|стойки (от gate)
GATHER|собираться
GATHERING|собрание, сборище -ing
GAUNT|Изможденный
GAVE|дал (от give)
GAY|веселый g-
GAZE|пристально глядеть, пристальный взгляд g-
GEAR|механизм
GEM|драгоценный камень
GENE|ген
GENERAL|общий
GENERALLY|вообще, обычно
GENERATE|порождать
GENERATION|поколение
GENERATIONS|Поколения
GENERATOR|Генератор
GENEROSITY|благородство, щедрость
GENEROUS|великодушный
GENIUS|гений
GENTLE|нежный, ласковый g-
GENTLEMAN|господин, джентльмен
GENTLEMEN|господа (от gentleman)
GENTLY|мягко, кротко g-
GENUINE|подлинный
GENUS|Род
GEOFF|Джеф
GEOFFREY|Джеффри
GEOGRAPHICAL|географический
GEOLOGICAL|Геологический
GEOLOGY|геология
GEOMETRY|геометрия
GEORGIANA|Георгиана
GERM|зародыш (биолог.), микроб
GERMAN|Немец
GERMANY|Германия
GESTURE|жест
GET|получать, доставать, достигать, добраться
GETS|действует (от get)
GETTING|передвижение
GHOST|привидение, дух
GHOSTS|Призраки
GIANT|гигант, гигантский
GIFT|подарок
GIFTED|одаренный
GIGANTIC|гигантский
GINNY|Гинни
GIPSY|цыганский, цыган(ка)
GIRL|девочка, девушка
GIVE|давать
GIVEN|данный (от give)
GLACIER|ледник, глетчер
GLAD|рад
GLADLY|С удовольствием
GLANCE|взглянуть, мелькнуть
GLANCED|Поглядел
GLANCING|Глядящий -ing
GLAND|железа
GLANDS|Гланды
GLARE|сверкать
GLASS|стакан, бокал
GLASSES|очки
GLEAM|проблеск, светиться
GLEAMED|Мерцал (не blinked)
GLEAMING|Блеск -ing
GLIDE|скользить, планировать (авиа)
GLIMPSE|мелькание, мельком взглянуть 
GLITTER|блеск, блестеть
GLITTERING|Сверкание -ing
GLOBE|земной шар, глобус
GLOOM|мрак, уныние
GLOOMILY|Уныло (не ruefully)
GLOOMY|мрачный (не dreary)
GLORIA|Глория
GLORIOUS|великолепный, славный
GLORY|слава
GLOSSY|глянцевитый, блестящий (о волосах)
GLOVE|перчатка
GLOVES|перчатки (от glove)
GLOW|сильный жар, накаляться (не heat)
GLOWING|Пылающий *l-ing
GLUE|клей; клеить, приклеивать
GNAW|грызть, глодать
GO|идти
GOAL|цель, гол
GOAT|козел, коза
GOATS|Козлы
GOD|бог, божество
GOES|идет (от go)
GOING|идущий (от go)
GOLAN|Голанский
GOLD|золото, золотой
GOLDEN|золотой, золотистый
GOOD|хороший, добрый, добро, польза
GOODBYE|прощание
GOODNESS|доброта; великодушие; любезность 
GOODS|товары
GOODWILL|добрая воля
GOON|придурок 
GOOSE|гусь
GOOSEBERRY|крыжовник
GOS|Идет
GOSH|боже 
GOSSIP|сплетня
GOT|получил, полученный (от get)
GOVERN|управлять g-
GOVERNMENT|правительство
GOVERNOR|губернатор
GOWN|платье
GRAB|внезапно схватывать
GRABBED|Захваченный
GRACE|грация, изящество
GRACEFUL|грациозный
GRACIOUS|милосердный gr-
GRADE|сортировать, степень
GRADUAL|постепенно
GRADUALLY|постепенно
GRADUATED|окончил, окончивший учебное заведение (от graduate)
GRAIN|зерно
GRAINS|Зерно *r-s
GRAM|грамм
GRAMMAR|грамматика
GRAND|величественный
GRANDCHILDREN|внуки
GRANDEUR|величие, великолепие, грандиозность g-
GRANDFATHER|дедушка
GRANDMOTHER|бабушка
GRANDPARENTS|дедушка и бабушка
GRANDSON|внук
GRANITE|гранит
GRANT|дарить, дар
GRANTED|дарованный 
GRAPES|виноград
GRAPHIC|графический, наглядный, образный
GRASP|понять, схватить
GRASS|трава
GRASSHOPPER|кузнечик
GRATE|каминная решетка
GRATEFUL|благодарный g-
GRATER|терка
GRATIFIED|Удовлетворенный (*r-)
GRATITUDE|благодарность
GRAVE|могила, серьезный, важный
GRAVEL|гравий
GRAVELY|серьезно, здраво, рассудительно (*r-) 
GRAVEYARD|Кладбище
GRAVITY|серьезность
GRAVY|подливка, соус
GRAY|Серый
GRAZE|задевать, оцарапать, содрать (кожу)
GREASE|жир, сало, мазь, смазка; смазывать (жиром)
GREASY|жирный, сальный
GREAT|великий
GREATER|больше 
GREATEST|самый большой (от great)
GREATLY|очень
GREEDY|жадный
GREEK|Грек
GREEN|зеленый
GREENHOUSE|Оранжерея
GREET|приветствовать
GREETED|приветствовал (от greet)
GREETING|приветствие, поклон -ing
GREETINGS|приветствия (от greeting)
GREW|рос (от grow)
GREY|серый
GRIDE|Скрип (не creak)
GRIEF|горе
GRIEVED|Огорченный
GRIEVOUSLY|горестно
GRILL|решетка
GRIM|жестокий, свирепый, мрачный
GRIMLY|жестоко, решительно 
GRIN|ухмыляться, усмешка
GRIND|молоть, толочь, точить
GRIP|схватывание
GROAN|стон, стонать
GROCER|бакалейщик
GROSS|большой (не large)
GROTESQUE|преувеличение
GROUND|земля
GROUNDS|Основания(земля)
GROUP|группа
GROUPING|классификация g-ing
GROUPS|Группы
GROW|расти
GROWING|растущий
GROWL|рычать, ворчать; рычание, ворчание g-
GROWLED|Рычал
GROWN|выращенный (от grow)
GROWTH|рост
GRUDGE|завидовать, жалеть (время, деньги)
GRUMBLE|ворчать
GRUNT|хрюкать, хрюканье
GUARANTEE|гарантия, гарантировать
GUARD|охрана, стража
GUARDED|Охраняемый
GUARDIAN|опекун, попечитель
GUARDS|Охраны
GUESS|отгадывать, догадка
GUESSING|гадание
GUEST|гость
GUESTS|гости (от guest)
GUFFAW|хохот
GUIDANCE|руководство
GUIDE|гид, экскурсовод
GUIDED|Управляемый(руководствуемый)
GUILT|вина, виновность g-
GUILTY|виноватый (g-)
GUINEA|гинея (золотая монета, денежная единица; = 21 шиллингу)
GULF|залив, бухта
GULL|чайка
GULPED|Проглоченный
GUM|смола, клей; склеивать(ся) (не tar)
GUMS|десны
GUN|ружье, пушка
GUNPOWDER|порох
GURGLE|бульканье (g-)
GUS|Гас
GUST|порыв (ветра)
GUTTER|водосточный желоб, канава
GUY|парень g- 
HABIT|привычка
HABITS|Привычки
HAD|вспомогательный глагол, имел (от have), не has
HAIL|приветствовать
HAIR|волосы
HAIRPIN|шпилька
HAIRS|Волосы
HAIRY|волосатый
HALF|половина
HALFWAY|на полпути 
HALL|зал
HALT|остановка, останавливать (не stop)
HALTED|Приостановленный *a-
HAM|ветчина
HAMMER|молоток
HAMMOCK|гамак
HAMPER|препятствие
HAND|рука
HANDBAG|дамская сумочка
HANDBOOK|справочник, руководство (не guidance)
HANDFUL|горсть
HANDKERCHIEF|носовой платок
HANDLE|обращаться с, управлять (не manage)
HANDLED|Обработанный
HANDLING|обращение -ing
HANDS|руки (от hand)
HANDSOME|красивый
HANDY|удобный; ловкий, искусный (h-)
HANG|повесить, висеть
HANGING|подвешивание
HANKY|носовой платок 
HANNAH|Ханна
HANS|Ханьшуй
HAPPEN|случаться, происходить
HAPPENED|случился (от happen)
HAPPENING|случай, событие
HAPPILY|счастливо
HAPPINESS|счастье
HAPPY|счастливый
HARASS|беспокоить
HARASSMENT|беспокойство
HARBOUR|гавань
HARD|с трудом, тяжело
HARDEN|твердеть
HARDER|больше, упорнее (от hard)
HARDLY|едва (не barely, merely)
HARDSHIP|лишение
HARDWORKING|трудолюбивый
HARE|заяц
HARI|Хари
HARM|беда, неприятность
HARMLESS|безвредный, безобидный
HARMONY|гармония, согласованность
HARNESS|упряжь, запрягать
HAROLD|Гарольд
HARP|арфа
HARRIET|Гарриет
HARSH|грубый, резкий (не sharp)
HARSHLY|грубо, резко
HART|олень h-
HARVEST|урожай
HAS|имеет (от have)
HASTE|спешка
HASTEN|торопить(ся)
HASTENED|поторопленный 
HASTILY|поспешно, опрометчиво
HASTY|поспешный, необдуманный
HAT|шляпа
HATCH|высиживать
HATCHET|топор(ик)
HATE|ненавидеть
HATED|ненавидел (от hate)
HATEFUL|ненавистный
HATRED|ненависть
HATS|Шляпы
HAUGHTY|высокомерный, надменный
HAUL|тянуть (не pull)
HAULED|Буксируемый
HAUNT|преследовать (о мыслях), появляться (как призрак)
HAUNTED|Часто посещаемый
HAVE|иметь, вспомогательный глагол
HAVEN|гавань, убежище
HAVING|имеющий, обладающий (от have)
HAY|сено
HAZARD|шанс, опасность h-
HAZE|легкий туман (не mist)
HE|он
HEAD|голова, главный, руководить
HEADACHE|головная боль
HEADER|Удар головой
HEADING|заголовок
HEADLESS|Безголовый
HEADLIGHT|фара (автомобиля), огни (паровоза)
HEADLINE|заголовок
HEADLONG|очертя голову
HEADMASTER|Директор школы
HEADPHONES|наушники
HEADQUARTERS|штаб
HEADS|головы (от head)
HEADSTONE|Надгробный камень
HEAL|излечивать
HEALTH|здоровье
HEALTHY|здоровый
HEAP|куча
HEAR|слышать
HEARD|слушал, услышанный (от hear)
HEARING|слух
HEART|сердце
HEARTH|печь, камин, домашний очаг
HEARTILY|сердечно
HEARTY|искренний, (чисто)сердечный, радушный
HEAT|жара
HEATING|отопление
HEAVEN|небо, небеса, бог, провидение
HEAVILY|тяжело
HEAVY|тяжелый
HEDGE|ограда
HEDGEHOG|еж
HEDWIG|Хедвиг
HEED|внимание, слушать внимательно
HEEDLESS|невнимательный, небрежный
HEEL|пятка, каблук
HEELS|пятки 
HEIGHT|высота
HEIR|наследник
HELD|держал 
HELIUM|Гелий
HELL|черт
HELLO|привет
HELM|руль
HELMET|шлем, каска
HELP|помощь, помогать
HELPED|помогал (от help)
HELPFUL|полезный h-
HELPING|помощь
HELPLESS|беспомощный
HEM|рубец, кромка, кайма; подшивать, подрубать
HEMP|конопля, пенька
HEN|курица
HENCE|следовательно
HENCEFORWARD|впредь, отныне
HENRIETTA|Генриетта
HER|ее, ей
HERD|стадо
HERE|здесь, вот
HEREAFTER|После этого(в будущем) (не afterward)
HEREDITARY|наследственный
HEREIN|в этом, при сем
HERMIONE|Хермион
HERMIT|отшельник
HERO|герой
HEROIC|героический
HEROISM|героизм, доблесть
HERON|цапля
HERRING|сельдь
HERS|ее
HERSELF|себя
HESITATE|колебаться
HESITATION|Колебание
HEY|эй 
HI|привет
HICK|провинциал, деревенщина 
HIDE|прятать, спрятать
HIDEOUS|безобразный, уродливый, страшный (не fearful)
HIGH|высокий (h-)
HIGHER|выше
HIGHLY|очень, весьма
HIGHNESS|высота, возвышенность (не altitude)
HIGHWAY|большая дорога, шоссе
HIKE|путешествовать пешком
HIKING|пеший поход
HILL|холм, гора
HILLS|Холмы
HILLSIDE|Склон
HIM|его, ему
HIMSELF|себя, себе, сам
HINDER|препятствовать, мешать
HINGE|петля, шарнир; висеть, вращаться на петлях
HINT|намек, намекать
HIP|ягода шиповника
HIRE|взять напрокат
HIS|его (-s)
HISS|свистеть, шипеть, свист
HISSED|шипящий (-ed) 
HIST|тише!, тс!
HISTORIC|исторический
HISTORICAL|исторический
HISTORY|история
HIT|успех, удача, попадать в цель
HITHERTO|до сих пор
HIVE|улей
HOARD|запас; запасать, копить (не spare, stock)
HOARSE|хриплый
HOAX|разыгрывать
HOBBLE|хромота, прихрамывать, ковылять
HOBBY|хобби
HOCKEY|хоккей
HOE|мотыга, рыхлить землю
HOG|свинья, боров
HOIST|поднимать (флаг, парус)
HOLD|держать(ся), выдерживать, захват, владение
HOLDER|владелец, ручка, рукоятка
HOLDING|удерживание, держащий (от hold)
HOLDS|Держится
HOLE|отверстие, яма
HOLES|Отверстия
HOLIDAY|отпуск, праздник
HOLIDAYS|каникулы (не vacation)
HOLLOW|пустой
HOLS|каникулы, отпуск 
HOLY|священный, святой
HOME|дом
HOMES|дома (от home)
HOMEWORK|домашнее задание
HONEST|честный
HONESTLY|честно 
HONEY|мед
HONEYCOMB|соты
HONOR|Честь
HONORABLE|Благородный
HONORARY|почетный
HONOUR|честь
HONOURABLE|почетный, почтенный, честный
HONOURED|Чтимый(удостоенный)
HOOD|капюшон, капор, колпак, крышка (тех.)
HOOF|копыто
HOOK|крючок
HOOKER|Проститутка
HOOKUP|Соединение
HOOP|обруч
HOOTER|Гудок (не buzzer)
HOP|хмель (бот.)
HOPE|надеяться
HOPED|надеялся (от hope)
HOPEFUL|надеющийся, подающий надежды, многообещающий
HOPEFULLY|с надеждой 
HOPELESS|безнадежный
HOPES|Надежды
HOPPED|Прыгал (не sprang, leaped, jumped)
HOPPER|Бункер
HORACE|Хорас
HORIZON|горизонт
HORIZONTAL|горизонтальный
HORIZONTALLY|Горизонтально
HORN|рог, забодать
HORNS|Рожки
HORRIBLE|ужасный h-
HORRID|ужасный *o- 
HORROR|ужас h-
HORSE|лошадь
HORSEMAN|наездник
HOSE|чулки
HOSPITAL|больница
HOSPITALITY|гостеприимство
HOST|хозяин
HOSTESS|хозяйка
HOSTILE|враждебный (не adverse)
HOSTILITY|враждебность (не adversity)
HOT|горячий
HOTEL|гостиница
HOTTER|жарче (от hot)
HOUR|час
HOURS|часы (от hour)
HOUSE|дом
HOUSEHOLD|домашнее хозяйство
HOUSEKEEPER|экономка
HOUSEWIFE|домашняя хозяйка
HOUSEWORK|работа по дому
HOVER|парить, вертеться
HOW|как
HOWEVER|однако
HOWL|выть, вой (не wail)
HRS|Часы
HUG|крепко обнимать
HUGE|огромный (не bulk)
HUGO|Хьюго
HUM|жужжать, гудеть
HUMAN|человеческий
HUMANITY|человечество
HUMBLE|скромный h-
HUMBUG|обманщик, ханжа
HUMOR|юмор
HUMOROUS|смешной
HUMOUR|юмор, настроение
HUMP|горб
HUNCHBACK|горбун
HUNDRED|сто
HUNDREDS|Сотни
HUNDREDTH|сотый
HUNG|вешал, был склонным 
HUNGER|голод (h-)
HUNGRY|голодный (не от слова starve)
HUNT|охотиться
HUNTER|охотник
HUNTING|охота
HURRICANE|ураган h-
HURRIED|спешил, торопился (от hurry)
HURRIEDLY|поспешно 
HURRY|спешить, торопиться, спешка
HURT|рана, болеть, причинить боль, повредить
HURTS|болеет, причиняет боль, повреждает (от hurt)
HUSBAND|муж
HUSH|водворять тишину
HUT|хижина
HYBRID|Гибрид
HYBRIDS|Гибриды
HYGIENIC|гигиенический
HYPOTHESIS|Гипотеза
HYSTERIA|истерия
HYSTERICAL|истерический
I|я
ICE|лед
ICEBOX|холодильник (морозильник) (не fridge)
ICICLE|сосулька
ICY|ледяной
IDEA|идея, мысль
IDEAL|идеал, идеальный
IDENTICAL|тождественный
IDENTIFICATION|отождествление
IDENTIFIER|Идентификатор
IDENTIFIERS|Идентификаторы
IDENTIFY|опознавать, распознавать; устанавливать личность
IDIOT|идиот
IDLE|бесполезный
IF|если
IGNITION|зажигание, воспламенение
IGNORANCE|незнание, невежество
IGNORANT|невежественный, неосведомленный, несведущий
IGNORE|игнорировать
ILL|больной
ILLEGAL|нелегальный
ILLITERATE|неграмотный
ILLNESS|болезнь
ILLUMINATE|освещать
ILLUMINATED|Освещенный
ILLUMINATION|освещение
ILLUSION|иллюзия
ILLUSTRATION|Иллюстрация
IMAGE|изображение, образ, имидж
IMAGINATION|воображение
IMAGINE|думать, воображать
IMITATE|подражать
IMITATION|подражание, имитация
IMMEDIATE|непосредственный
IMMEDIATELY|немедленно
IMMENSE|громадный, необъятный
IMMENSELY|чрезвычайно i-
IMMERSED|Погруженный
IMMINENT|надвигающийся
IMMORTAL|бессмертный
IMPACT|удар (не stroke)
IMPATIENCE|нетерпение
IMPATIENT|нетерпеливый
IMPATIENTLY|нетерпеливо
IMPEDIMENT|препятствие
IMPENETRABLE|непроницаемый
IMPERATIVE|повелительное наклонение (грам.)
IMPERFECT|несовершенный
IMPERIAL|Имперский
IMPERTINENCE|дерзость
IMPLEMENT|выполнять
IMPLEMENTATION|Выполнение
IMPLEMENTED|Осуществленный
IMPLIED|подразумеваемый (i-)
IMPOLITE|невежливый, неучтивый
IMPORT|импорт, ввоз
IMPORTANCE|важность
IMPORTANT|важный
IMPOSE|налагать
IMPOSSIBLE|невозможный
IMPOSTOR|самозванец, плут
IMPRESS|производить впечатление
IMPRESSION|впечатление
IMPRESSIVE|впечатляющий -ve
IMPRISON|заключать в тюрьму
IMPROBABLE|невероятный
IMPROVE|улучшать
IMPROVED|улучшил (от improve)
IMPROVEMENT|улучшение
IMPROVEMENTS|Усовершенствования
IMPULSE|побуждение, порыв
IMPURE|нечистый, грязный, с примесью
IN|в
INABILITY|неспособность
INACCESSIBLE|недоступный
INCESSANT|непрерывный, вечный
INCH|дюйм
INCHES|Дюймы
INCIDENT|инцидент
INCIDENTALLY|между прочим
INCLINATION|склонность
INCLINE|склонять
INCLINED|наклонный
INCLUDE|включать
INCLUDED|включенный (от include)
INCLUDING|включая
INCLUSION|включение
INCOME|доход, заработок
INCOMPREHENSIBLE|непонятный, непостижимый i-
INCONSISTENT|непоследовательный
INCONVENIENT|неудобный
INCORRECT|неверный, неправильный
INCREASE|рост
INCREASING|возрастающий
INCREASINGLY|все больше и больше
INCREDIBLE|невероятно
INCUR|подвергаться
INDEBTED|обязанный
INDEED|неужели, действительно (не really)
INDEFINITE|неопределенный, неограниченный
INDEPENDENCE|независимость
INDEPENDENT|независимый
INDEPENDENTLY|независимо
INDEX|индекс, указатель, показатель
INDEXES|Индексы
INDIANS|Индусы(индейцы)
INDICATE|показывать, указывать
INDICES|Индексы (не indexes)
INDIFFERENCE|безразличие
INDIFFERENT|безразличный
INDIGENOUS|местный
INDIGESTION|несварение, расстройство
INDIGNANT|негодующий, возмущенный
INDIGNATION|негодование, возмущение
INDIRECT|косвенный
INDIVIDUAL|личность, индивидуальный
INDOLENT|ленивый, праздный, безболезненный
INDOORS|в помещении
INDUCE|убеждать
INDUCED|Вынужденный(вызванный)
INDUSTRIAL|промышленный
INDUSTRIOUS|трудолюбивый, прилежный (не hardworking)
INDUSTRY|промышленность
INEFFECTIVE|неэффективный
INEVITABLE|неизбежный
INFANT|младенец
INFER|заключать, делать вывод
INFERIOR|худший, плохой
INFINITE|безграничный, бесконечный
INFINITELY|бесконечно
INFLECTED|Склоняемый
INFLECTION|Сгибание
INFLICT|наносить удар
INFLUENCE|влияние, влиять
INFLUENCED|влиял (от influence)
INFO|Информация
INFORM|сообщать
INFORMATION|информация
INFORMED|осведомленный
INFORMS|Сообщает
INGA|Инга
INGENIOUS|изобретательный, остроумный, находчивый
INGRATITUDE|неблагодарность
INGREDIENT|составная часть
INHABIT|жить, обитать
INHABITANT|житель
INHABITANTS|Жители
INHABITED|Населенный *n-
INHALE|вдыхать
INHERENT|неотъемлемый, присущий, свойственный (не Integral)
INHERIT|(у)наследовать
INHERITANCE|наследство
INHERITED|Унаследованный
INITIAL|начальный, первоначальный
INITIALLY|вначале i-
INITIATE|начинать (не commence)
INJECT|впрыскивать
INJUNCTION|предписание
INJURE|ушибиться -e
INJURED|поврежденный i-
INJURY|телесное повреждение
INJUSTICE|несправедливость
INK|чернила
INLAND|внутренний
INN|гостиница, постоялый двор
INNER|внутренний
INNOCENCE|невинность, невиновность
INNOCENT|наивный, невинный
INNUMERABLE|бесчисленный
INPUT|Вход
INQUIRE|спрашивать, узнавать
INQUIRED|осведомлённый (не informed) 
INQUIRIES|справочное (от inquiry)
INQUIRY|расспросы, наведение справок
INQUISITIVE|любопытный
INSANE|душевнобольной, ненормальный
INSCRIPTION|надпись
INSECT|насекомое
INSECTS|Насекомые
INSECURE|ненадежный, небезопасный (insecure)
INSERT|вставлять, помещать (в газете)
INSIDE|внутрь, внутри
INSIGNIFICANT|незначительный, ничтожный
INSIST|настаивать
INSOLENT|наглый, дерзкий, оскорбительный
INSPECT|осматривать, инспектировать
INSPECTION|осмотр
INSPECTOR|контролер, инспектор i-
INSPIRATION|вдохновение
INSPIRED|Вдохновленный
INSTALL|водворять, устраивать, устанавливать
INSTALLATION|Установка
INSTALLED|Установленный
INSTALLER|Монтажник
INSTALLING|Монтаж -ing
INSTALLS|Устанавливает
INSTANCE|пример
INSTANCES|Случаи *n-
INSTANT|мгновение
INSTANTLY|немедленно
INSTEAD|вместо, взамен
INSTINCT|инстинкт
INSTINCTIVE|инстинктивный
INSTITUTION|учреждение
INSTRUCT|инструктировать
INSTRUCTION|инструкция
INSTRUCTOR|инструктор
INSTRUMENT|инструмент
INSUFFICIENT|недостаточный
INSULT|оскорбление
INSURANCE|страхование, страховка
INTAKE|поглощение
INTEGER|Целое число
INTEGRAL|неотъемлемый
INTELLECTUAL|интеллигент
INTELLIGENCE|интеллект
INTELLIGENT|умный
INTEND|намереваться
INTENDED|предполагаемый i-
INTENSE|интенсивный, напряженный
INTENT|намерение, цель i-
INTENTION|намерение, замысел
INTENTIONAL|умышленный
INTENTIONS|Намерения
INTENTLY|внимательно 
INTERBASE|Межоснова
INTERCEPT|перехватывать
INTERCOURSE|общение
INTERDEPENDENT|взаимозависимый
INTEREST|интересовать, заинтересовывать
INTERESTED|заинтересованный, интересующийся (от interest)
INTERESTING|интересный
INTERFACE|Интерфейс
INTERFERE|мешать
INTERFERENCE|вмешательство
INTERFERING|Вмешательство -ing
INTERIOR|внутренний (не internal)
INTERMEDIATE|Промежуточное звено
INTERNAL|внутренний
INTERNATIONAL|международный
INTERPOSED|Вставленный
INTERPRET|интерпретировать, переводить(устно) i-
INTERRUPT|прерывать, мешать
INTERRUPTION|прерывание
INTERVAL|антракт, промежуток
INTERVALS|Интервалы
INTERVENTION|посредничество
INTERVIEW|встреча, беседа
INTIMATE|глубокий, интимный
INTIMIDATE|пугать, запугивать
INTO|в
INTOLERABLE|невыносимый, нестерпимый
INTRICATE|запутанный (не entangled)
INTRIGUE|интрига
INTRODUCE|предстaвлять, знакомить
INTRODUCTION|введение
INTRUDE|вторгаться, вмешиваться, навязываться
INVADE|вторгаться
INVADER|захватчик
INVALID|недействительный (не Illegal)
INVALUABLE|неоценимый
INVARIABLY|неизменно
INVENT|изобретать, изобрести
INVENTION|выдумка, изобретательность
INVENTOR|изобретатель
INVENTORY|опись
INVEST|вкладывать, помещать (капитал)
INVESTIGATE|исследовать
INVESTIGATION|исследование
INVESTIGATOR|исследователь
INVISIBLE|невидимый
INVITATION|приглашение
INVITATIONS|приглашения (от invitation)
INVITE|приглашать
INVITED|пригласил, приглашенный (от invite)
INVOLUNTARY|невольный
INVOLVE|втягивать, вовлекать
INVOLVED|сложный
INWARD|внутрь
IRENE|Ирэн
IRON|железо, утюг
IRONIC|иронический
IRONICAL|иронический
IRREGULAR|неправильный
IRRESISTIBLE|непреодолимый
IRRESOLUTE|нерешительный
IRRESPONSIBILITY|безответственность
IRRITATION|раздражение
IS|есть (от be)
ISABELLA|Изабелла
ISLAND|остров
ISLE|остров(ок)
ISO|Международная организация по стандартизации
ISOBEL|Исобел
ISOLATION|изоляция
ISSUE|выпуск, издание, выпускать
ISSUED|Выпущенный
ISSUES|Проблемы(выпуски)
IT|это, он, она (для предметов и животных)
ITALIAN|Итальянец
ITALY|Италия
ITEM|вещь, предмет
ITS|его, ее (от it)
ITSELF|себя, себе
IVAN|Иван
IVORY|слоновая кость
IVY|плющ
JACK|домкрат
JACKAL|шакал
JACKET|куртка
JACKSON|Джэксон
JAIL|тюрьма
JAKE|Джейк
JAM|варенье, джем
JAMES|Джеймс
JAN|Январь
JANUARY|январь
JAR|ссора
JAW|челюсть
JAWS|Челюсти
JAZZ|джаз
JEALOUS|ревнивый
JEALOUSY|ревность
JEAN|Хлопчатобумажная ткань
JEANNE|Джин
JEANS|джинсы
JEER|насмешка *e-
JEFF|Джеф
JELLY|желе
JENNY|Дженни
JERK|резкий толчок, подергивание; резко толкать, дергать
JERSEY|джемпер (-.....s....-)
JERUSALEM|Иерусалим
JESSAMY|Джессами
JESSIE|Джесси
JEST|шутка; шутить, высмеивать (не joke)
JET|струя (воды, пара, газа)
JEW|Еврей
JEWEL|драгоценность
JEWELLER|ювелир
JEWELLERY|ювелирные изделия
JEWELS|драгоценности
JILL|Джилл
JIM|Джим
JO|Джо
JOAN|Джоан
JOB|работа
JOBS|работы (от job)
JOE|кофе 
JOIN|соединяться
JOINING|соединение
JOINT|совместный, объединенный (j-)
JOKE|шутка, шутить
JOKING|шутка, шутящий (от joke)
JOLLY|очень, веселый
JONAS|Джонас
JOSEPH|Джозеф
JOSEPHINE|Джозефина
JOSIE|Джоси
JOURNAL|журнал j-
JOURNEY|путешествие
JOY|радость
JOYFUL|радостный, довольный
JOYFULLY|Радостно *o-
JUDGE|судья
JUDGED|Оцененный *u- (не valued)
JUDGEMENT|приговор, суждение
JUDGMENT|Суждение
JUG|кувшин
JUICE|сок
JUICY|сочный, дождливый
JULY|июль
JUMBLE|толкаться
JUMP|прыгать
JUMPED|прыгал(а) (от jump)
JUMPER|джемпер
JUNE|июнь
JUNGLE|джунгли
JUNIOR|младший
JUNK|рухлядь 
JURY|присяжные, жюри
JUST|только, всего лишь, справедливый
JUSTICE|справедливость
JUSTIN|Джастин
JUSTLY|справедливо
JUVENILE|юноша, подросток *u-
KALGAN|Калган
KATE|Кейт
KAZAN|Казань
KEEL|киль
KEEN|страстный
KEEP|(со)держать, сохранять
KEEPER|хранитель, смотритель, сторож
KEEPING|хранение, содержание, согласие (k...ing)
KENNEL|(собачья) конура, собачий питомник
KENNETH|Кеннет
KEPT|заставил (от keep)
KERB|обочина
KERNEL|ядро, зерно
KETTLE|чайник
KEY|ключ
KEYHOLE|замочная скважина
KICK|пинать, пнуть
KID|ребенок (разг.), обманывать (сленг.)
KIDDING|шутящий, высмеивающий (от kid)
KIDNAP|похищать (человека)
KIDNEY|почка (анатом.)
KIDS|дети (от kid)
KILL|убивать
KILLED|убил (от kill)
KILLING|убийственный (-ing)
KIND|добрый, вид, род
KINDLY|добрый, добродушный, ласково, любезно
KINDNESS|доброта, любезность (k-)
KING|король
KINGDOM|королевство
KINGS|Короли
KISS|целовать
KIT|ранец, багаж
KITCHEN|кухня
KITTEN|котенок
KITTY|цель (в игре в кегли)
KNEE|колено
KNEES|колени 
KNELT|стоял на коленях 
KNEW|знал (от know)
KNIFE|нож
KNIGHT|рыцарь
KNIGHTS|Рыцари
KNIT|вязать, связывать
KNITTED|вязанный, трикотажный
KNOB|
KNOCK|стучать, стук
KNOCKED|стучать (2 форма) *n- 
KNOT|узел, завязывать узел (не kink)
KNOW|знать
KNOWING|знание, знающий
KNOWLEDGE|знание
KONRAD|Конрад
LA|Ла
LABEL|этикетка, приклеивать ярлык
LABOR|Рабочая сила
LABORATORY|лаборатория
LABOUR|труд, трудиться
LABOURER|рабочий
LACE|кружево, шнурок
LACK|недостаток
LAD|мальчик, юноша, парень (не guy)
LADDER|лестница (не stairs)
LADEN|Груженый, нагруженный, обремененный
LADIES|дамы (от lady)
LADS|парни (не guys) 
LADY|дама, госпожа
LAID|происходил, совершался (от lay)
LAKE|озеро
LAMB|ягненок, баранина
LAME|хромой
LAMENT|сетование, жалоба (l-)
LAMP|лампа
LAND|земля, суша, приземляться, высаживаться на берег
LANDED|земельный
LANDING|высадка на берег -ing
LANDLADY|хозяйка (дома, гостиницы) (не mistress)
LANDLORD|домовладелец
LANDSCAPE|ландшафт, пейзаж
LANDSLIDE|оползень, обвал (не avalanche)
LANE|дорожка (не road)
LANGUAGE|язык
LANTERN|фонарь
LAP|подол
LAPSE|описка
LARD|топленое свиное сало
LARGE|большой
LARGELY|обильно *a-
LARGER|Больший
LARGEST|Самый большой
LARK|жаворонок
LARVA|личинка, головастик
LASH|хлестать, ударять; плеть
LAST|прошлый, последний, продолжаться, длиться
LASTLY|Наконец
LATCH|запирать(ся)
LATE|поздно
LATELY|за последнее время
LATER|позже
LATERAL|Боковой *a-
LATEST|последний (не latter)
LATTER|последний
LAUGH|смех, смеяться
LAUGHED|смеялся, хохотал (от laugh)
LAUGHING|смех, смеющийся
LAUGHTER|смех, хохот
LAUNCH|начинать
LAUNCHING|спуск (на воду), начало -ing
LAUNDRY|прачечная, стирка
LAURIE|Лаури
LAVISH|щедрый, обильный
LAW|закон, право
LAWN|лужайка
LAWS|Законы
LAWYER|адвокат, юрист
LAY|класть, положить
LAYING|Наложение -ing
LAZINESS|лень
LAZY|ленивый
LEAD|вести, руководить
LEADER|глава, лидер
LEADERSHIP|руководство
LEADING|лидирование, руководящий
LEADS|Лидерство
LEAF|лист
LEAFLET|Рекламный листок
LEAFLETS|Рекламные листки
LEAGUE|союз, лига
LEAK|просачиваться
LEAN|прислоняться, наклоняться, наклон
LEAP|високосный, прыжок, прыгать
LEAPED|Прыгал (не sprang, jumped, hopped)
LEAPT|прыгал 
LEARN|узнать, учиться
LEARNED|ученый
LEARNING|учение
LEARNT|узнал, выученный (от learn)
LEASE|аренда, сдавать в аренду
LEASH|поводок, цепь (не strap)
LEAST|наименьший, менее всего
LEATHER|кожа, кожаный
LEAVE|оставлять, покидать, уезжать
LEAVING|уезжающий (от leave)
LECTURE|лекция
LEDGE|выступ, край l-
LEE|Защита
LEFT|покинутый, оставленный (от leave)
LEG|нога
LEGACY|наследство
LEGAL|законный
LEGALLY|законно
LEGEND|легенда
LEGITIMATE|обоснованный
LEISURE|досуг
LEISURELY|не спеша
LEMON|лимон
LEMONADE|лимонад
LEND|дать в долг
LENGTH|длина
LENS|линза
LENT|одолжил, дал в долг (от lend)
LESS|менее, в меньшей степени (от little)
LESSEN|уменьшать l-
LESSON|урок
LET|позволять, давать, разрешать
LETTER|письмо
LETTERS|письма (от letter)
LETTING|Разрешение -ing
LETTUCE|салат
LEVEL|уровень
LEVER|рычаг
LIABLE|подлежащий, обязанный, ответственный
LIAR|лгун
LIBERAL|либеральный, щедрый; либерал
LIBERTY|свобода
LIBRARIAN|библиотекарь
LIBRARIES|Библиотеки
LIBRARY|библиотека
LICENCE|лицензия, разрешение (*****c*)
LICENSE|давать разрешение
LICK|лизать
LID|крышка
LIE|ложь, лгать, лежать
LIFE|жизнь
LIFEBOAT|спасательная лодка
LIFT|поднимать, подъемник, лифт
LIGHT|свет, освещение, фара, освещать, зажигать
LIGHTER|зажигалка
LIGHTHOUSE|маяк
LIGHTING|освещение
LIGHTLY|слегка 
LIGHTNING|молния
LIGHTS|фары (от light)
LIKE|любить, нравиться, похожий, подобный
LIKED|нравился, любил (от like)
LIKELIHOOD|вероятность
LIKELY|вероятно
LIKENESS|сходство l-
LIKEWISE|так же 
LILAC|сирень, сиреневый
LILY|лилия
LIMB|конечность (анат.)
LIMBS|конечности 
LIME|известь
LIMIT|предел, граница
LIMITATION|ограничение
LIMITED|ограниченный
LIMITS|Пределы
LIMP|хромота, прихрамывать
LINE|линия, специальность
LINED|Выровненный
LINEN|белье
LINGER|медлить, задерживаться
LINING|подкладка
LINK|соединять, соединить (link)
LION|лев
LIP|губа
LIQUID|жидкость
LIQUOR|крепкий спиртной напиток
LIST|список
LISTEN|слушать
LISTENED|слушал (от listen)
LISTENER|слушатель
LIT|освещённый 
LITERAL|буквальный
LITERARY|литературный
LITERATURE|литература
LITTER|мусор, сорить
LITTLE|мало, маленький
LIVE|жить
LIVED|жил, живший (от live)
LIVELY|живой, оживленный
LIVER|печень
LIVING|средства к существованию, жизнь
LIZARD|ящерица
LIZZIE|Автомобильчик
LOAD|нагрузка, нагружать
LOADED|загруженный
LOAF|безделье
LOAN|заём, ссуда
LOBBY|вестибюль
LOBES|Лепестки
LOBSTER|омар
LOCAL|местный
LOCATE|определять местоположение 
LOCATED|Расположенный
LOCATION|местоположение
LOCATIONS|Местоположения
LOCK|замок, запирать на замок
LOCKED|запертый l-
LOCKING|Захват -ing
LOCKS|Замки
LOCKSMITH|слесарь
LODGE|разместить
LODGING|квартира, жилье
LOFT|сеновал, чердак
LOFTY|высокий, возвышенный
LOG|бревно
LOGIC|логика
LOGIN|Логин
LOGS|Бревна
LONELINESS|одиночество 
LONELY|одинокий
LONG|длинный, долгий, долго
LONGER|длиннее (от long)
LOOK|смотреть, выглядеть, взгляд, внешность
LOOKING|смотрящий (от look) -ing
LOOKS|выглядит (от like)
LOOM|принимать размеры
LOOP|петля
LOOSE|свободный
LOOSEN|развязывать, распускать, ослаблять
LOOT|ограбление
LORD|лорд
LORRY|грузовик (не truck)
LOS|Лос
LOSE|терять, проигрывать
LOSING|проигрыш, проигранный
LOSS|потеря, утрата
LOST|потерял, проиграл, потерянный, проигранный (от lose)
LOT|много
LOTS|уйма, куча, множество (не pile) 
LOUD|громкий
LOUDER|громче
LOUDLY|громко
LOUISA|Луиза
LOUISE|Луиза
LOVE|любовь, любить
LOVED|любил (от love)
LOVELY|прекрасный, восхитительный l-
LOVER|любитель, возлюбленный
LOVERS|Любители(возлюбленные)
LOVING|любящий
LOW|низкий
LOWER|нижний, снижать, опускать
LOWERED|Пониженный
LOYAL|верный, лояльный
LOYALTY|верность
LUCIDLY|понятно, ясно *u-
LUCIUS|Лусиус
LUCK|удача, везение
LUCKILY|к счастью
LUCKY|счастливый, удачный
LUCY|Люси
LUGGAGE|багаж
LUKE|Лук
LUMBER|лесоматериалы *u-
LUMP|глыба, ком
LUNCH|второй завтрак, обед
LUNCHEON|обед, лёгкая закуска
LUSTRE|блеск, лоск, глянец, люстра
LUXURIOUS|роскошный
LUXURY|роскошь
LYDIA|Лидия
MACHINE|машина
MACHINERY|машины, механизмы
MAD|обезумевший
MADAM|госпожа
MADAME|Мадам
MADE|делал, сделанный (от make)
MADEIRA|Мадейра
MADLY|безумно 
MAGAZINE|журнал
MAGAZINES|журналы (от magazine)
MAGIC|волшебный m-
MAGICIAN|волшебник
MAGNIFICENT|великолепный m-
MAID|горничная
MAIL|почта, отправлять (по почте)
MAIN|главный
MAINLAND|материк
MAINLY|главным образом
MAINTAIN|поддерживать
MAINTAINED|Обслуженный(поддержанный)
MAINTENANCE|поддержание
MAJESTY|величественность, величество (титул)
MAJOR|специализироваться, главный m-
MAJORITY|большинство
MAKE|делать, производить
MAKER|производитель (m-)
MAKES|делает (от make)
MAKING|создание, становление (процесс) 
MALE|мужчина, самец
MALICE|злоба
MALICIOUS|злобный
MALIGNANT|злобный, злостный, злокачественный (****g)
MALLET|деревянный молоток
MALLOW|Просвирник
MAMA|Мама
MAMMA|Мама
MAN|мужчина, человек
MANAGE|справляться, ухитряться, управлять
MANAGEMENT|управление
MANAGER|управляющий
MANAGES|ухитряется (от manage)
MANE|грива
MANIA|мания
MANIFEST|явный, проявлять(ся) m-
MANIPULATE|манипулировать
MANIPULATION|Манипуляция
MANKIND|человечество
MANNER|способ, образ действия, манера
MANNERS|способы (не methods) 
MANOEUVRE|маневр, маневрировать
MANSFIELD|Мансфилд
MANSION|дворец
MANTLE|покрывать, окутывать
MANUAL|ручной
MANUFACTURE|производство, производить m-
MANURE|удобрение
MANUSCRIPT|рукопись
MANY|много (с исчисляемыми существительными)
MAP|карта
MARBLE|мрамор
MARCH|маршировать
MARCHED|Прошел
MARCO|Марко
MARGARET|Маргарет
MARGARITA|Маргарита
MARGIN|минимум, нижняя грань, предел
MARIA|Мария
MARIANNE|Мэрианн
MARINE|морской флот, морской
MARINER|моряк
MARK|норма, состояние, оценка, отметка
MARKET|рынок
MARKS|оценки (от mark)
MARMOT|сурок
MARQUIS|Маркиз
MARRIAGE|свадьба
MARRIED|женатый, замужняя
MARRY|жениться, выходить замуж
MARRYING|Бракосочетание -ing
MARSH|болото m-
MARTIAL|военный
MARVEL|удивляться, поражаться m-
MARVELLOUS|удивительный, замечательный m-
MASK|маска
MASON|каменщик
MASQUERADE|маскарад, маскироваться
MASS|масса, множество
MASSES|Массы
MASSIVE|массивный
MAST|мачта
MASTER|хозяин (не hoster)
MASTERPIECE|шедевр
MAT|коврик (не rug)
MATCH|спичка, матч
MATCHES|Сделки, спички
MATE|товарищ
MATERIAL|материал
MATERIALS|Материалы
MATHEMATICAL|математический
MATHS|математика
MATTER|дело, сущность, материал
MATTERS|дела, материалы (от matter)
MATTRESS|матрац
MATURE|зрелый, созреть
MATURITY|зрелость
MAUD|Дорожный плед
MAXIM|принцип
MAXIMUM|Максимум
MAY|май
MAYBE|мoжет быть
MAYOR|мэр
ME|мне, меня
MEADOW|луг
MEAL|еда, есть, принимать пищу (не food)
MEALS|еда (от meal)
MEAN|означать
MEANING|значение
MEANINGLESS|бессмысленный
MEANS|средство, способ
MEANT|означаемый, подразумеваемый 
MEANTIME|между тем
MEANWHILE|тем временем, между тем
MEASLES|корь
MEASURE|мера
MEASURED|Измеренный
MEASURES|Меры
MEASURING|измерения (от measure)
MEAT|мясо, мясной
MECHANIC|механик
MECHANICAL|механический
MECHANICS|механика
MECHANISM|устройство
MEDAL|медаль
MEDDLE|вмешиваться
MEDICAL|медицинский
MEDICINE|медицина, лекарство
MEDIEVAL|средневековый
MEDITATE|размышлять, обдумывать
MEDIUM|средство, середина
MEEK|кроткий
MEET|встречать(ся), знакомиться
MEETING|встреча
MEG|Мэг
MELANCHOLY|Меланхолия
MELON|дыня
MELT|таять
MEMBER|член
MEMBERS|члены (от member)
MEMORABLE|памятный
MEMORANDUM|памятная записка
MEMORY|память
MEN|мужчины (от man)
MENACE|опасность (не danger)
MEND|чинить, ремонтировать
MENDED|починил, починенный (от mend)
MENTAL|умственный
MENTALLY|умственно
MENTION|благодарность, упоминать
MENTIONED|упомянул (от mention)
MENU|меню
MERCHANDISE|торговля
MERCHANT|торговец (не salesman)
MERCIFUL|милосердный (не gracious)
MERCURY|ртуть
MERCY|милость
MERE|простой
MERELY|единственно
MERGE|Слиться
MERIT|достоинство
MERRY|веселый, радостный m-
MESS|беспорядок, путаница
MESSAGE|сообщение, поручение
MESSENGER|посыльный, курьер
MET|встречались, встреченный (от meet)
METAL|металл, металлический
METER|счетчик
METHOD|метод
METROPOLITAN|столичный
MEXICAN|Мексиканец
MICE|мыши
MICROPHONE|микрофон
MICROSCOPE|микроскоп
MID|средний
MIDDAY|полдень
MIDDLE|средний
MIDNIGHT|полночь
MIDST|середина
MIGHT|можно, возможно (от may)
MIGHTY|могущественный
MILD|мягкий (не soft)
MILDRED|Милдред
MILE|миля
MILES|мили (от mile)
MILITARY|военный
MILK|молоко
MILL|фабрика, завод, мельница
MILLET|просо, пшено
MILLION|миллион
MILLIONS|Миллионы
MIND|память, мнение, помнить, возражать
MINDED|Склонный
MINDS|ум 
MINE|мой (употребляется без последующего существительного)
MINERAL|минeральный
MINGLED|Смешанный
MINIATURIZATION|Миниатюризация
MINIMS|Мельчайшая частица, очень маленькая доля, капля
MINIMUM|минимум
MINING|горный -ing
MINISTER|министр
MINISTRY|министерство
MINOR|младший, незначительный, второстепенный
MINORITY|меньшинство
MINT|мята
MINUS|минус
MINUTE|минута
MINUTES|минуты (от minute)
MIRACLE|чудо
MIRROR|зеркало
MIRTH|веселье, радость
MISCELLANEOUS|смешанный, разнообразный m-
MISCHIEF|зло, беда
MISCHIEVOUS|злонамеренный, злобный, шаловливый, озорной
MISERABLE|несчастный
MISERY|страдания, нищета
MISFORTUNE|несчастье (m-)
MISHAP|неудача (не unluck)
MISLEAD|вводить в заблуждение
MISS|промах, промахнуться, пропустить, скучать
MISSING|недостающий, отсутствующий, пропавший (без вести)
MISSION|миссия
MISSIONARY|миссионер
MIST|дымка
MISTAKE|ошибка
MISTAKEN|ошибочный (от mistake)
MISTRESS|хозяйка, госпожа
MISTY|туманный mi-
MIX|смешивать, мешать
MIXTURE|микстура
MM|Мм
MOAN|оплакивать, стонать
MOANING|Стенание -ing
MOB|толпа, сборище
MOBILE|подвижный
MOCK|насмехаться (не jeer)
MOCKERY|издевательство
MODE|способ
MODEL|модель
MODERATE|умеренный
MODERATELY|Умеренно
MODERN|современный
MODEST|скромный m-
MODIFICATION|Модификация
MODIFIED|видоизменённый 
MODIFY|модифицировать
MODULE|Модуль
MOIST|сырой, влажный m-
MOISTURE|влажность (не humidity)
MOLE|крот
MOLLY|Молли
MOMENT|момент, миг
MOMENTARY|Мгновенный
MOMENTUM|импульс
MONARCH|монарх
MONDAY|понедельник
MONEY|деньги
MONKEY|обезьяна
MONKS|Монахи
MONOTONOUS|однообразный, монотонный
MONSIEUR|Господин
MONSTER|чудовище
MONSTERS|Монстры
MONSTROUS|чудовищный
MONTH|месяц
MONTHLY|(еже)месячный, ежемесячно
MONTHS|месяцы (от month)
MONUMENT|памятник (не memorial)
MONUMENTS|памятники (от monument)
MOOD|настроение
MOON|луна
MOONLIGHT|лунный свет 
MOP|швабра, подтирать
MORAL|нравственный
MORE|еще, больше
MOREOVER|кроме того
MORNING|утро
MORROW|завтра, завтрашний день; следующий день 
MORSEL|кусочек -l
MORTAL|смертный, смертельный (не lethal)
MORTGAGE|заклад, залог
MORTIMER|Мортимер
MORTON|Мортон
MOSCOW|Москва
MOSQUITO|комар
MOSS|мох
MOSSY|мшистый
MOST|самый, весьма
MOSTLY|главным образом (не mainly)
MOTEL|мотель, гостиница
MOTH|моль, мотылек
MOTHER|мама
MOTION|движение
MOTIONLESS|неподвижный
MOTIVE|повод, мотив
MOTIVES|Поводы
MOTLEY|разноцветный, пестрый
MOTOR|мотор
MOULD|плесень; плесенный грибок
MOUND|насыпь, холмик
MOUNT|взбираться m-
MOUNTAIN|гора
MOURN|сетовать
MOURNFUL|грустный
MOURNING|траур
MOUSE|мышь
MOUSTACHE|усы
MOUTH|рот
MOVE|двигать(ся), переезжать
MOVEMENT|движение
MOVEMENTS|Движения
MOVIE|кино, фильм
MOVIES|кино, фильмы (от movie)
MOVING|трогательный
MOW|косить
MS|Госпожа
MUCH|много (с неисчисляемыми существительными)
MUD|грязь
MUDDY|грязный, мутный
MUFFLED|закутанный, укутанный, завёрнутый (не wrapped) 
MUFFLER|шарф
MUG|кружка
MUGGY|теплый, влажный, удушливый
MULBERRY|Тутовое дерево
MULE|мул, тупица, гибрид, туфля без задников
MULTI|Много
MULTIPLE|многократный -e
MULTITUDE|множество
MUMBLE|бормотание m-
MUMMY|Мумия
MUNCH|чавкать
MURAL|стенная живопись, фреска
MURDER|убийство
MURDERER|убийца
MURMUR|шорох, шепот m-
MUSCLE|мышца
MUSCLES|Мускулы
MUSCULAR|мускулистый
MUSEUM|музей
MUSIC|музыка
MUSICAL|музыкальный, мюзикл
MUSICIAN|музыкант
MUST|должен, надо
MUTE|немой (не dumb)
MUTINY|мятеж, поднять мятеж
MUTTER|бормотать
MUTTERED|Бормотал
MUTTERING|Бормотание -ing
MUTTON|баранина
MUTUAL|взаимный, общий (не common)
MUZZLE|морда, намордник, дуло
MY|мой, моя, мое, мои
MYRTLE|Мирт
MYSELF|себя, меня самого, себе, сам
MYSTERIOUS|таинственный
MYSTERY|тайна
MYTH|миф
NAB|курок
NAIL|ноготь, гвоздь
NAILS|ногти (от nail)
NAIVE|наивный
NAKED|обнаженный, голый
NAME|имя, фамилия, называть
NAMELY|а именно
NAN|Нэн
NANCY|Нэнси
NAPKIN|салфетка, пеленка
NAPOLEON|Наполеон
NARRATIVE|повествование, рассказ
NARROW|узкий
NASTY|скверный, плохой
NAT|Нат
NATION|нация, народ
NATIONAL|национальный
NATIONS|Нации
NATIVE|родной
NATIVES|Аборигены
NATURAL|естественный
NATURALIST|Натуралист
NATURALISTS|Натуралисты
NATURALLY|естественно
NATURE|природа
NAUGHTY|непослушный
NAVIGATION|судоходство, плавание, навигация
NAVY|военный флот
NAY|более того, даже; отрицательный ответ; отказ;
NEAR|близко от, около
NEARBY|поблизости (nearby)
NEAREST|ближайший (от near)
NEARLY|почти, приблизительно (не almost)
NEAT|чистый, опрятный n-
NEATLY|аккуратно 
NECESSARILY|обязательно
NECESSARY|нужный, необходимый
NECESSITY|необходимость
NECK|шея
NECKLACE|ожерелье
NED|Нед
NEED|нуждаться в, надо, нужда, потребность
NEEDLE|игла
NEEDLEWORK|шитье
NEGATIVE|отрицательный, отрицание, негатив
NEGLECT|пренебрегать
NEGLECTED|Пренебрег
NEGLIGENCE|небрежность
NEGOTIATE|договариваться
NEIGHBOUR|сосед
NEIGHBOURHOOD|соседство
NEIGHBOURING|соседний
NEITHER|также не
NELL|Нелл
NEPHEW|племянник
NERVE|нерв
NERVES|нервы (от nerve)
NERVOUS|нервный
NEST|гнездо
NET|сеть
NETWORK|сеть
NEUTRAL|нейтральный
NEVER|никогда
NEVERTHELESS|тем не менее
NEVILLE|Невилл
NEW|новый
NEWCOMER|новичок (не beginner)
NEWLY|вновь (не again)
NEWS|новости, известия
NEWSLETTER|новости
NEWSPAPER|газета
NEWSPAPERS|газеты (от newspaper)
NEXT|следующий, соседний, затем, потом
NICE|хороший, чудесный, приятный
NICELY|хорошо
NICER|лучше (от nice)
NICEST|самый вкусный (от nice)
NICHE|ниша
NICHOLAS|Николас
NICK|Зарубка
NICKEL|никл (монета в 5 центов)
NICKNAME|прозвище
NIECE|племянница
NIECES|Племянницы
NIGHT|ночь
NIGHTINGALE|соловей
NIGHTMARE|кошмар
NIGHTS|ночи (от night)
NINE|девять
NINETEEN|девятнадцать
NINETEENTH|девятнадцатый
NINETY|девяносто
NINTH|девятый
NIP|укус, щипать, пересечь
NO|нет, никакой
NOBLE|благородный, знатный
NOBLEMAN|дворянин
NOBLES|Знать (знатные люди)
NOBODY|никто
NOD|кивать головой, кивок
NODDING|Кивающий
NODE|Узел (не knot)
NOISE|шум
NOISELESS|бесшумный
NOISES|Шумы
NOISY|шумный
NON|не
NONE|нисколько, совсем не, вовсе не
NONSENSE|чепуха, ерунда
NOON|полдень
NOR|и не, также не
NORMAL|нормальный
NORMALLY|обычно n-
NORMANDY|Нормандия
NORRIS|Норрис
NORTH|север
NORTHERN|северный
NOSE|нос
NOSTRIL|ноздря
NOSTRILS|Ноздри
NOT|не
NOTABLE|заметный
NOTABLY|исключительно
NOTE|запись, записка, банкнота, записывать
NOTEBOOK|тетрадь (n-)
NOTHING|ничто, ничего
NOTICE|извещение, сообщение, замечать, обращать внимание
NOTIFY|извещать, уведомлять (не inform)
NOTION|понятие
NOTIONS|Понятия
NOTORIOUS|известный, отъявленный
NOTWITHSTANDING|несмотря на, тем не менее, однако
NOURISHING|питательный (-ing)
NOURISHMENT|питание, пища
NOVEL|роман
NOVELTY|новизна, новинка
NOVEMBER|ноябрь
NOW|сейчас
NOWADAYS|в наше время
NOWHERE|нигде, никуда
NUISANCE|досада
NULL|Пустой указатель
NULLS|Пустые указатели
NUMB|онемелый, оцепенелый (не dumb, )
NUMBER|номер
NUMBERS|Номера(числа)
NUMERALS|числительные (от numeral)
NUMERIC|Числовой
NUMEROUS|многочисленный
NURSE|няня (не nanny)
NURSERY|детский, ясли
NUT|орех
NUTS|орехи (от nut)
NYLON|нейлон, нейлоновый
OAK|дуб
OAR|весло
OARS|вёсла 
OATH|клятва, присяга
OBEDIENCE|послушание
OBEDIENT|послушный
OBEY|подчиняться, слушаться
OBJECT|возражать, предмет
OBJECTED|Возразил (не retorted)
OBJECTION|возражение, протест
OBJECTIONS|возражения (от objection)
OBJECTIVE|цель, стремление (-ve)
OBJECTS|Объекты(цели)
OBLIGATION|обязательство
OBLIGE|обязывать
OBLIGED|обязан, признателен (от oblige)
OBSCURE|затемнять, затруднять понимание
OBSERVATION|наблюдение, замечание
OBSERVE|наблюдать, замечать (не outlook)
OBSERVED|наблюдаемый 
OBSERVER|наблюдатель
OBSTACLE|препятствие
OBTAIN|добиваться
OBTAINED|Полученный *b-
OBVIOUS|очевидный o-
OBVIOUSLY|очевидно o-
OCCASION|случай, обстоятельство
OCCASIONAL|случайный
OCCASIONALLY|изредка
OCCASIONED|Причиняемый
OCCUPATION|занятие
OCCUPIED|занятый 
OCCUPY|занимать, завоёвывать
OCCUR|случаться
OCCURRENCE|Возникновение
OCCURS|Происходит
OCEAN|океан
OCTAVIAN|Октавиан
OCTOBER|октябрь
ODD|странный
ODDS|разница, неравенство
ODOUR|запах, аромат o-
OF|предлог родительного падежа (кого?, чего?)
OFF|прочь, от
OFFENCE|обида
OFFEND|обижать, обидеть (o-)
OFFENDED|обиженный 
OFFENSIVE|наступление
OFFER|предлагать
OFFERING|предложение
OFFICE|офис, контора
OFFICER|служащий, офицер
OFFICIAL|официальный, чиновник
OFFICIALLY|официально
OFFSET|смещенный
OFFSPRING|Потомство
OFTEN|часто
OH|O!
OIL|масло
OK|все в порядке
OLD|старый
OLDEST|старший, самый старый
OLIVE|олива, маслина; оливкового цвета
OMELETTE|омлет
OMINOUS|зловещий
OMIT|опускать, пропускать, упускать
ON|на, вперед, дальше
ONCE|один раз, однажды
ONESELF|(самого) себя o-
ONION|лук
ONLY|только, единственный
ONTO|на (не upon)
ONWARD|вперед, далее, продвигающийся вперед
OPEN|открывать
OPENED|открыл, открытый (от open)
OPENING|начало, открытие
OPENLY|открыто
OPERA|опера
OPERATE|действовать
OPERATING|управляющий -ing
OPERATION|действие, операция
OPERATIVE|действующий o-ve
OPERATOR|оператор
OPINION|мнение
OPPONENT|соперник
OPPORTUNITY|возможность
OPPOSED|Противопоставленный
OPPOSITE|противоположный
OPPOSITION|противодействие
OPPRESSIVE|гнетущий, деспотический
OPT|выбирать
OPTION|выбор (o-)
OPTIONAL|Дополнительный
OPTIONS|Выбора
OR|или
ORANGE|апельсин, оранжевый
ORANGES|апельсины (от orange)
ORCHARD|фруктовый сад
ORCHESTRA|партер, оркестр
ORDER|порядок, приказ, заказ, заказывать, приказывать
ORDERED|приказал (от order)
ORDERLY|аккуратный
ORDINAL|порядковый
ORDINARILY|обыкновенным, обычным путем; обычно; нормально; в обычной степени
ORDINARY|обычный, простой
ORGAN|орган
ORGANIC|органический
ORGANIZATION|организация
ORGANIZE|организовывать
ORGANIZED|организовывал (от organize)
ORGANIZER|организатор
ORGANS|Органы
ORIENTAL|восточный
ORIGIN|происхождение
ORIGINAL|оригинал, первоначальный
ORIGINALLY|первоначально
ORIGINATE|возникать, происходить, давать начало, порождать; создавать
ORNAMENT|украшение, орнамент; украшать
ORPHAN|сирота, сиротский
OSTRICH|страус
OTHER|другой
OTHERWISE|иначе
OUGHT|долженствование
OUR|наш
OURS|наш
OURSELVES|себя, себе, сами
OUT|вне, вон, из, снаружи, наружный
OUTBREAK|взрыв, вспышка, начало (войны и т.п.)
OUTCOME|результат
OUTCRY|крик, протест
OUTDOOR|на открытом воздухе
OUTER|внешний
OUTFIT|снаряжение, обмундирование, оборудование
OUTLAW|человек вне закона, изгнанник
OUTLET|выход, выходное отверстие
OUTLINE|контур, конспект, план, схема; краткое содержание
OUTPUT|выпуск, продукция
OUTRAGE|нарушение закона, насилие, оскорблять
OUTRIGHT|открыто, прямо; без утайки (не straight, directly)
OUTSIDE|снаружи, наружный
OUTSKIRTS|окраина (города), опушка (леса)
OUTSTANDING|выдающийся *u-
OUTWARD|внешний, наружный (не outside)
OUTWIT|перехитрить
OVEN|печь
OVER|через, над, сверх
OVERALL|всеобщий o-
OVERCOAT|пальто
OVERCOME|преодолеть
OVERFLOW|переливаться через край, заливать, переполнять
OVERHEAD|наверху, над головой, верхний
OVERHEAR|подслушивать
OVERJOYED|вне себя от радости, очень довольный
OVERLOAD|перегружать
OVERLOOK|надзирать
OVERRIDE|наехать, переехать; задавить Отвергнуть
OVERTHROW|свергать
OVERTIME|сверхурочные
OVERTURN|опрокидывать(ся), ниспровергать
OVERWHELM|засыпать, забрасывать (вопросами), сокрушать
OVERWHELMING|несметный
OWE|быть должным
OWEN|Оуэн
OWING|должный
OWL|сова
OWN|иметь, владеть, свой, собственный
OWNER|владелец
OWNERS|Владельцы
OWNERSHIP|собственность
OX|бык
OXBOW|ярмо
OXYGEN|кислород
OYSTER|устрица
OYSTERS|устрицы (от oyster)
OZ|Унция
PACE|шагать
PACIFIC|мирный
PACK|упаковывать, упаковать
PACKAGE|пакет
PACKET|пакет (не bundle)
PAD|мягкая прокладка, подушка; подбивать (ватой и т.п.)
PADDLE|короткое весло, грести одним веслом; шлепать по воде
PADLOCK|висячий замок
PAGE|страница
PAID|платил, оплаченный (от pay)
PAIL|ведро
PAIN|боль, страдание
PAINFUL|причиняющий боль, мучительный
PAINS|боли, страдания (от pain)
PAINT|красить, краска
PAINTER|художник
PAINTING|живопись
PAIR|пара
PAIRS|Пары
PAL|приятель, товарищ, дружок
PALACE|дворец
PALE|бледный
PALM|ладонь
PAMPHLET|брошюра, памфлет
PAN|сковорода
PANE|оконное стекло
PANEL|комиссия
PANG|острая боль
PANIC|паника
PANT|задыхаться (не gasp)
PANTOMIME|Пантомима
PANTRY|кладовая, чулан (не closet)
PAPER|бумага, газета
PARADE|парад
PARAGRAPH|параграф
PARALLEL|параллельный
PARAMETER|Параметр
PARAMETERS|Параметры
PARCEL|пакет *a-
PARCHMENT|Пергамент
PARDON|извинение
PARENT|родитель, родственник
PARENTS|родители (от parent)
PARK|парк, (при)парковать(ся)
PARKED|Припаркованный
PARKING|стоянка
PARLIAMENT|парламент
PARLOR|Комната
PARLOUR|кабинет p-
PARROT|попугай
PARROTS|Попугаи
PARSLEY|петрушка (бот.)
PART|часть, доля, роль, делить, расставаться, расходиться
PARTED|Разделенный
PARTIAL|частичный
PARTIALLY|Частично
PARTICIPATE|участвовать
PARTICLES|Частицы
PARTICULAR|особый
PARTICULARLY|особенно, в особенности
PARTIES|вечеринки (от party)
PARTING|прощание
PARTITION|разделение
PARTLY|частично
PARTNER|участник
PARTS|части (от part)
PARTY|вечеринка, группа
PASS|передавать, проходить, пропуск, перевал
PASSAGE|проход
PASSAGES|проходы 
PASSED|прошел (от pass)
PASSENGER|пассажир
PASSENGERS|Пассажиры
PASSING|прохождение
PASSION|страсть
PASSIONATE|страстный
PASSWORD|Пароль
PASSWORDS|Пароли
PAST|после, за
PASTE|тесто, клейстер, паста; клеить, склеивать
PASTURE|пастбище
PAT|хлопок
PATCH|заплатка
PATH|тропинка, беговая дорожка
PATHETIC|трогательный
PATHS|Дорожки (не roads, lanes)
PATIENCE|терпение
PATIENT|пациент, терпеливый
PATIENTLY|Терпеливо
PATROL|патруль
PATSY|Паци
PATTED|Ласкал
PATTERN|модель
PAUL|пол 
PAUSE|пауза
PAUSING|Приостановка -ing
PAVEMENT|тротуар (не sidewalk)
PAW|лапа
PAWS|Лапы
PAY|платить, зарплата
PAYING|платеж
PAYMENT|плата
PEA|горох
PEACE|мир
PEACEABLE|миролюбивый, мирный
PEACEFUL|мирный, спокойный
PEACEFULLY|мирно
PEACH|персик
PEACHES|персики (от peach)
PEACOCK|павлин
PEAK|вершина
PEAL|трезвон, раскат грома
PEANUT|земляной орех
PEAR|груша
PEARL|жемчуг, жемчужный
PEARLS|Жемчуг
PEARS|груши (от pear)
PEAS|горошек, горох
PEBBLE|галька, горный хрусталь
PECK|клевать
PECULIAR|особенный p-
PECULIARITIES|Особенности
PEDAL|педаль
PEDESTRIAN|пешеход
PEEKS|(он) Посмотрит -s
PEEL|чистить, почистить
PEEP|проблеск, выглядывать
PEER|вглядываться, всматриваться p-
PEERED|Глядел (*e-)
PEERING|Глядя -ing
PEEVES|Обиды
PEG|целиться
PEN|ручка
PENCIL|карандаш
PENDING|во время, в течение
PENETRATE|проникать внутрь
PENHOLDER|ручка (для пера)
PENKNIFE|перочинный нож
PENNY|пенни
PENSIONER|пенсионер
PEOPLE|люди
PEPPER|перец
PER|в
PERCEIVE|воспринимать, ощущать
PERCEIVED|Воспринятый
PERCENT|процент
PERCY|Перси
PERFECT|совершенный
PERFECTION|совершенство
PERFECTLY|совершенно, вполне
PERFORM|делать, выполнять
PERFORMANCE|спектакль
PERFORMED|Выполненный (не от слова fulfil)
PERFUME|духи
PERHAPS|возможно, может быть
PERIL|опасность
PERILOUS|опасный, рискованный
PERIOD|период
PERIODIC|периодический
PERIODS|Периоды
PERMANENT|постоянный
PERMANENTLY|постоянно
PERMISSIBLE|допустимый
PERMISSION|разрешение
PERMIT|разрешать
PERMITTED|Разрешенный
PERPENDICULAR|перпендикулярный
PERPETUAL|вечный, постоянный p-
PERRY|Перри
PERSECUTION|преследование
PERSEVERANCE|настойчивость, упорство
PERSIAN|Персидский
PERSISTENT|настойчивый
PERSON|человек, особа, лицо, личность
PERSONAL|личный
PERSONALLY|лично
PERSONS|Люди
PERSPECTIVE|перспектива, перспективный
PERSUADE|убеждать
PERSUADED|Убежденный (не convinced)
PERVERSE|извращенный, испорченный, превратный
PEST|паразит, вредитель, бич
PET|любимое домашнее животное, любимец
PETER|Питер
PETITION|петиция, прошение, подавать петицию
PETROL|бензин
PETS|домашние животные (от pet)
PHANTOM|Фантом
PHASE|фаза, фазировать
PHILADELPHIA|Филадельфия
PHILIP|Филип
PHILOSOPHICAL|философский
PHILOSOPHY|философия
PHONE|телефон
PHOSPHATE|Фосфат
PHOTO|фотография
PHOTOGRAPH|фотография, фотографировать
PHOTOGRAPHER|фотограф
PHOTOGRAPHIC|фотографический
PHOTOGRAPHING|фотографирование
PHOTOGRAPHY|фотография
PHRASE|фраза
PHYSICAL|физический
PHYSICALLY|физически
PHYSICIAN|врач
PIANO|пианино
PICK|собирать, подбирать, выбирать
PICKED|собранный, выбранный 
PICKLES|маринованные огурцы
PICNIC|пикник
PICTURE|картина, изображение, рисовать, описывать
PICTURES|картины (от picture)
PICTURESQUE|живописный
PIE|пирог
PIECE|кусок
PIER|пристань, мол, свая, бык
PIERCE|пронзать, протыкать, пронизывать, проникать
PIERRE|Пирр
PIG|свинья
PIGEON|голубь
PIGEONS|Голуби
PIGS|Свиньи
PIKE|щука (не lung)
PILE|куча, груда, кипа, пачка
PILED|Сложенный
PILLAR|колонна, столб p-
PILLOW|подушка
PILLS|таблетки (от pill)
PILOT|пилот
PIN|булавка, значок, прикалывать
PINCERS|клещи, щипцы
PINCH|щипать, прищемить, щипок
PINCHING|Зажимание -ing
PINE|сосна
PINEAPPLE|ананас
PINK|розовый
PINS|значки (от pin)
PIOUS|набожный
PIPE|труба (не tube)
PIRATE|пират
PISTOL|револьвер, пистолет
PIT|яма, партер (не dig)
PITCH|бросок, уровень, сооружать
PITCHED|Переданный
PITCHER|подающий
PITEOUS|жалкий, жалобный
PITIFUL|жалкий, ничтожный
PITY|жалость
PIZZA|пицца
PLACE|место
PLACING|Размещение -ing
PLAIN|ясный, очевидный, равнина
PLAINLY|Явно (не clearly, obvious)
PLAINS|Равнины
PLAN|план, планировать
PLANE|самолет
PLANES|самолеты (от plane)
PLANET|планета
PLANETS|Планеты
PLANK|доска (p-)
PLANNED|плановый
PLANNING|планирование
PLANS|планы (от plan)
PLANT|завод, растение, сажать, внедрять, посадить
PLANTATION|плантация
PLANTS|Заводы(растения)
PLASTER|пластырь, штукатурка, штукатурить
PLASTIC|пластмасса, пластичный
PLATE|тарелка
PLATES|тарелки (от plate)
PLATFORM|платформа
PLATFORMS|Платформы
PLAY|играть, игра (play)
PLAYED|играл (от play)
PLAYER|плейер, игрок
PLAYING|играющий (от play)
PLAYS|играет (от play)
PLAYWRIGHT|драматург
PLEADED|Умолял
PLEASANT|приятный
PLEASANTLY|приятно 
PLEASE|пожалуйста (только в просьбе)
PLEASED|довольный
PLEASURE|удовольствие
PLENTY|изобилие, избыток, вполне, довольно
PLOT|заговор
PLOUGH|пахать
PLUCK|ощипывать, выщипывать, рвать (цветы)
PLUCKY|смелый, отважный (не manful)
PLUG|пробка (не cork)
PLUM|слива
PLUMAGE|Оперение
PLUME|перо
PLUMP|пухлый, полный (не swell)
PLUMS|сливы (от plum)
PLUNDER|добыча, грабить
PLUNGE|нырять p-
PLUNGED|Погруженный
PLURAL|множественное число (грам.)
PLUS|плюс
POCKET|карман
POCKETS|карманы 
POD|стручок, лущить
POEM|стихотворение, поэма
POEMS|стихи (от poem)
POET|поэт
POETRY|поэзия, стихи
POINT|точка, пункт, суть дела, указывать, показывать
POINTED|острый, многозначительный, совершенно очевидный
POINTING|указывающий (-ing) 
POINTS|Пункты(точки)
POISON|яд, отравлять
POISONOUS|ядовитый
POKE|толчок, тыкать
POKING|Тыкание -ing
POLAR|полярный
POLE|полюс
POLICE|полиция
POLICEMAN|полицейский
POLICY|политика
POLISH|лак
POLITE|любезный, вежливый
POLITELY|вежливо 
POLITENESS|Вежливость
POLITICAL|политический
POLITICS|политика
POLL|подсчет (голосов), голосование; голосовать, подсчитывать голоса
POLLEN|Пыльца
POMPEY|Помпей
POND|пруд (не pool)
PONY|пони
POOL|пруд, бассейн
POOR|бедный
POORLY|плохо, неважно
POP|поп, популярный
POPPED|Совавший
POPULAR|популярный
POPULATION|население, жители
PORCELAIN|фарфор
PORCH|крыльцо, (амер.) веранда, терраса
PORE|пора
PORK|свинина
PORRIDGE|каша
PORT|порт
PORTABLE|переносной
PORTED|Перенесенный, транспортированный
PORTER|носильщик
PORTION|часть, доля (не section, segment)
PORTIONS|Части *o-
PORTRAIT|портрет
PORTS|порты (от port)
POSE|поза, ставить (вопрос, задачу)
POSITION|положение
POSITIVE|положительный
POSITIVELY|Положительно
POSSESS|обладать
POSSESSED|хладнокровный, владеющий собой, одержимый 
POSSESSION|владение
POSSIBILITY|возможность p-
POSSIBLE|возможный
POSSIBLY|возможно
POST|почта, после
POSTAGE|почтовые расходы
POSTAL|почтовый
POSTCARD|почтовая открытка
POSTER|плакат
POSTMAN|почтальон
POSTPONE|отсрочивать
POT|котелок
POTATO|картофель
POTATOES|картофель (от potato)
POTENTIAL|потенциал, потенциальный
POTENTIALLY|потенциально
POTION|Микстура
POTIONS|Микстуры
POTS|Горшки
POTTER|Гончар
POULTRY|домашняя птица
POUNCE|налетать
POUND|фунт, фунт стерлингов
POUNDS|фунты (от pound)
POUR|лить
POURED|Лил
POVERTY|бедность
POWDER|пудра
POWER|держава, энергия, сила, мощность (не force)
POWERFUL|могущественный, сильный
POWERFULLY|сильно (p-)
POWERS|Полномочия
PRACTICABLE|осуществимый
PRACTICAL|практический
PRACTICALLY|практический
PRACTICE|практика
PRACTICED|применял, практиковал (от practice)
PRACTISE|заниматься
PRAISE|хвалить
PRAISED|хвалил (от praise)
PRANK|проделка, разряжаться
PRAY|молить
PRAYER|молитва, просьба
PRAYERS|Просьбы(просители)
PRE|Пред
PREACH|проповедовать
PRECARIOUS|ненадежный *r-
PRECAUTION|предосторожность
PRECEDING|предшествующий -ing
PRECIOUS|драгоценный
PRECISE|точный
PRECISELY|точно
PRECISION|точность
PREDATOR|хищник
PREDICATE|сказуемое (грам.)
PREDICTION|предсказание
PREFER|предпочитать
PREFERENCE|предпочтение
PREFERRED|предпочитал (от prefer)
PREFIX|(грам.) префикс, приставка
PREGNANT|беременная, чреватый (последствиями и т. п.)
PRELIMINARY|предварительный (p- не preparatory)
PREPARATION|приготовление
PREPARATIONS|Приготовления
PREPARE|готовить(ся)
PREPARED|готовился, готовый (от prepare)
PREPARING|Подготовка
PREPONDERANT|преобладающий
PRESCRIPTION|рецепт
PRESENCE|присутствие
PRESENT|настоящее время, подарок, настоящий, присутствующий
PRESENTED|Представленный
PRESENTIMENT|предчувствие
PRESENTLY|вскоре
PRESENTS|подарки (от present)
PRESERVATION|сохранение, сохранность, консервирование
PRESERVE|сохранять
PRESERVED|Сохраненный
PRESIDENT|президент
PRESS|(по)гладить, сжимать, нажимать, печать, пресса
PRESSED|поглаженный, сжатый (от press)
PRESSING|срочный, настойчивый
PRESSURE|давление
PRESUMABLY|возможно
PRESUME|предполагать (не suppose)
PRETENCE|притворство
PRETEND|притворяться, делать вид
PRETTY|хороший, значительный
PREVAIL|торжествовать (не triumph)
PREVAILED|Преобладал
PREVENT|предотвращать, препятствовать
PREVENTED|Предотвращенный
PREVIEW|предварительный просмотр
PREVIOUS|предшествующий
PREVIOUSLY|предварительно
PREY|жертва
PRICE|цена
PRICELESS|бесценный
PRICK|(у)колоть(ся)
PRICKLY|колючий
PRIDE|гордость
PRIEST|священник
PRIMARY|первичный
PRIME|главный (не chief, major)
PRINCE|принц
PRINCESS|Принцесса
PRINCIPAL|главный, основной, важнейший p-
PRINCIPLE|принцип
PRINCIPLES|Принципы
PRINT|печатать, напечатать
PRINTING|печатание
PRIOR|прежний
PRIORITY|приоритет
PRISON|тюрьма
PRISONER|заключенный
PRISONERS|Заключенные
PRIVACY|уединенность
PRIVATE|частный
PRIVATELY|конфиденциально
PRIVILEGE|привилегия
PRIVILEGED|привилегированный
PRIZE|приз
PROBABILITY|вероятность
PROBABLE|вероятный (-e)
PROBABLY|вероятно (-y)
PROBLEM|проблема
PROBLEMS|проблемы (от problem)
PROCEDURE|процедура
PROCEDURES|Процедуры
PROCEED|продолжать
PROCEEDING|поступок, мероприятие, протоколы, записки
PROCEEDINGS|труды, записки
PROCESS|процесс
PROCESSES|Процессы
PROCESSION|процессия
PROCLAMATION|воззвание, прокламация
PROCURATOR|Поверенный
PROCURE|доставать, добывать
PROCURED|Обеспеченный (не provided, supplied)
PRODUCE|производить
PRODUCED|производил (от produce)
PRODUCER|режиссер
PRODUCES|Производит
PRODUCING|Создание -ing
PRODUCT|продукция
PRODUCTION|производство
PRODUCTIONS|Производство
PROFESSION|профессия
PROFESSIONAL|профессиональный
PROFESSOR|профессор
PROFIT|прибыль
PROFITABLE|прибыльный, выгодный, полезный
PROFOUND|глубокий
PROGRAM|программа
PROGRAMME|программа
PROGRAMMES|программы, передачи (от programme)
PROGRAMMING|программирование
PROGRAMS|программы (от program)
PROGRESS|прогресс, успех
PROHIBITED|запрещенный (от prohibit)
PROJECT|проект
PROJECTS|проекты (от project)
PROLONG|продлевать
PROMINENT|выдающийся
PROMISE|обещать
PROMISED|обещал (от promise)
PROMISING|многообещающий -ing
PROMOTION|поощрение
PROMPT|проворный, быстрый
PROMPTLY|быстро
PRONE|склонный
PRONOUNCE|произносить
PRONOUNCED|Явный
PRONUNCIATION|произношение
PROOF|доказательство
PROP|подпорка, опора, подпирать
PROPER|правильный
PROPERLY|правильно, должным образом
PROPERTY|собственность, имущество
PROPHET|пророк
PROPORTION|пропорция
PROPOSAL|предложение
PROPOSE|предлагать (не suggest)
PROPOSED|Предложенный
PROPOSITION|предложение
PROSPECT|перспектива
PROSPECTS|Перспективы
PROSPER|процветать
PROSPERITY|процветание, благосостояние
PROSPEROUS|преуспевающий
PROTECT|защищать, предохранять
PROTECTED|Защищенный
PROTECTION|защита
PROTECTIVE|защитный
PROTEST|протестовать, протест
PROTOCOL|Протокол
PROUD|гордый
PROUDLY|гордо
PROVE|доказывать, доказать
PROVED|Доказанный
PROVIDE|обеспечивать
PROVIDED|при условии
PROVIDENCE|провидение
PROVISION|заготовка
PROVISIONS|Условия (не conditions)
PROVOCATIVE|вызывающий, провокационный
PROVOKE|вызывать, провоцировать
PRUDENT|осторожный, благоразумный (не careful)
PRY|любопытный человек
PSYCHOLOGY|психология
PUB|трактир, гостиница
PUBLIC|общественный (не social)
PUBLICATION|публикация
PUBLICITY|гласность
PUBLICLY|публично
PUBLISH|публиковать
PUBLISHED|публиковал, опубликованный (от publish)
PUDDING|пудинг
PUDDLE|лужица, смущать, барахтаться в воде
PUFF|дымок, дуновение (ветра); дымить, попыхивать p-
PUG|мопс, моська, курносый нос
PULL|тянуть, тащить
PULLOVER|пуловер
PULP|мякоть, бумажная масса
PULSE|пульс, пульсировать
PUMP|насос
PUMPKIN|тыква
PUN|каламбур
PUNCH|пробивать (отверстия), ударять кулаком, удар кулаком, пунш
PUNCTUAL|пунктуальный, аккуратный
PUNISH|наказывать, наказать
PUNISHMENT|наказание
PUPIL|ученик
PURCHASE|покупка, покупать
PURCHASER|покупатель
PURE|чистый
PURGE|чистка (не clean)
PURPLE|лиловый, малиновый
PURPOSE|цель
PURPOSES|Цели
PURSE|кошелек
PURSUE|преследование
PURSUED|Преследуемый
PURSUING|Преследование -ing
PURSUIT|преследование, погоня, занятие
PUSH|толкать
PUSHED|вытолкнутый 
PUSHING|Подталкивание(выдвижение) -ing
PUT|класть, размещать
PUZZLE|приводить в затруднение, загадка
PUZZLED|озадачен, поставлен в тупик (от puzzle)
PYJAMAS|пижама
PYRAMID|пирамида
QUALIFY|квалифицировать
QUALITIES|Качества
QUALITY|качество
QUANTITY|количество
QUARREL|ссора, ссориться
QUARTER|четверть, квартал
QUARX‡|d‡z ноломня, карьер
QUAY|набережная
QUEEN|королева
QUEER|странный, эксцентричный
QUENCH|утолять (жажду)
QUERY|вопрос, спрашивать
QUEST|поиски
QUESTION|вопрос
QUESTIONABLE|сомнительный
QUESTIONS|вопросы (от question)
QUICK|быстрый
QUICKER|быстрее (от quick)
QUICKLY|быстро
QUIET|тихий, спокойный
QUIETLY|тихо, спокойно
QUILL|катушка q-
QUIT|прекращать
QUITE|вполне, совсем
QUIVER|дрожать, трепетать; дрожь; трепет
QUIVERING|дрожащий -ing (не от слов tremble, shiver)
QUIZ|опрос, проверять знания
QUOTATION|цитата
QUOTE|цитировать
QUOTED|Указанный
RABBIT|кролик
RABBITS|Кролики
RACE|раса, гонка
RACES|Гонки(расы)
RACING|гоночный (-ing)
RACK|полка для багажа над сиденьем
RACKET|ракетка
RADIANT|лучистый, сияющий, лучезарный
RADIATOR|радиатор
RADIO|радио
RADIOACTIVE|радиоактивный
RAFT|плот 
RAG|тряпка, лохмотья
RAGE|гнев, ярость (не fury)
RAGGED|истрепанный, оборванный, рваный r-
RAID|нападение
RAIL|рельс
RAILING|ограда, перила -ing
RAILROAD|железная дорога
RAILWAY|железная дорога
RAIN|дождь
RAINBOW|радуга
RAINCOAT|плащ
RAINY|дождливый
RAISE|поднимать, возвышать
RAISED|рельефный
RAISING|воспитание
RAKE|грабли, сгребать
RALPH|Ральф
RAM|баран
RAN|бежал, убежавший (от run)
RANCH|ранчо
RANDOM|случайный, беспорядочный
RANG|звонил 
RANGE|ряд, линия, диапазон
RANGER|скиталец
RANK|ряд, чин, выстраивать
RANSOM|выкуп, выкупать
RAPID|быстрый r-
RAPIDLY|быстро
RAPT|восхищенный, похищенный
RAPTURE|восторг, восхищение (не delight)
RARE|редкий, недожаренный
RARELY|редко
RASH|стремительный, поспешный, опрометчивый; сыпь
RASPBERRY|малина
RAT|крыса
RATE|тариф, расценка, степень, оценивать
RATES|стоит (от rate)
RATHER|скорее, лучше
RATIONAL|рациональный
RATTLE|трещать, греметь, грохотать; треск, грохот, погремушка, трещотка
RAW|сырой
RAY|луч
RAYMOND|Раймонд
RAZOR|бритва
REACH|достигать
REACT|реагировать
REACTION|реакция
READ|читать
READER|читатель
READILY|охотно r-
READINESS|находчивость
READING|чтение
READY|готовый
REAL|реальный, настоящий
REALISTIC|реалистический
REALITY|действительность
REALIZE|представлять себе, реализовать
REALLY|на самом деле, действительно r-
REALM|Царство
REAR|задняя часть
REARED|Воздвигнутый
REASON|причина, довод, разум, рассудок
REASONABLE|разумный r-
REASONABLY|разумно
REASONING|Рассуждение -ing
REASSURE|заверять
REBELLION|восстание, бунт
REBELLIOUS|мятежный, бунтарский
REBUFF|неудача, отпор
RECALL|припомнить, отозвать
RECALLED|Отозванный
RECEIPT|квитанция
RECEIVE|получать
RECEIVER|приемник
RECEIVING|Получение -ing
RECENT|недавний
RECENTLY|недавно
RECEPTION|прием
RECIPE|рецепт
RECITE|рассказывать, перечислять
RECKLESS|отчаянный, безрассудный, опрометчивый
RECKON|считать
RECOGNITION|узнавание
RECOGNIZE|узнавать, узнать
RECOIL|отдача, отпрянуть, испытывать ужас
RECOLLECT|припоминать
RECOLLECTION|воспоминание (не reminiscence)
RECOMMEND|рекомендовать
RECOMMENDED|Рекомендуемый
RECONNAISSANCE|разведка
RECONSTRUCT|реконструировать
RECORD|запись, пластинка, отчет, рекорд
RECORDED|Зарегистрированный
RECORDER|записывающее устройство
RECORDING|регистрация -ing
RECORDS|пластинки (от record)
RECOVER|выздоравливать
RECOVERY|выздоровление
RECREATE|Заново создавать, воскрешать, освежиться
RECRUIT|вербовать, нанимать
RED|красный
REDEEM|выкупать, искупать, выполнять (обещание и т.п.)
REDUCE|уменьшать, понижать, сокращать
REDUCED|Уменьшенный (не lowered)
REDUCING|понижает (от reduce)
REDUCTION|снижение
REED|тростник, камыш (не cane)
REEDS|Тростники (не canes)
REEL|катушка, барабан (тех.); пошатываться, спотыкаться (не coil)
REFER|отсылать, ссылаться r-
REFERENCE|рекомендация, ссылка, справка
REFERENCES|рекомендации (от reference)
REFERRED|Отнесенный
REFERS|Обращается(относится)
REFLECT|отражать, размышлять
REFLECTED|Отраженный
REFLECTING|отражающий
REFLECTION|отражение, размышление
REFLECTIONS|Отражения
REFORM|улучшать, реформа
REFRAIN|удерживать, сдерживать, воздерживаться
REFRESH|освежать
REFRESHMENT|подкрепление
REFRESHMENTS|закуски и напитки
REFRIGERATOR|холодильник
REFUGE|убежище
REFUSAL|отказ
REFUSE|отказывать
REFUSED|отказался (от refuse)
REGAIN|достичь
REGARD|взгляд, внимание, смотреть, считать *e-
REGARDED|Расцененный
REGARDING|Относительно *e-ing
REGARDLESS|независимо от
REGARDS|привет, поклон
REGIMENT|полк
REGION|район, область
REGIONS|Области(регионы)
REGISTER|(за)регистрировать
REGISTERED|зарегистрированный, заказной (от register)
REGISTRATION|регистрация
REGISTRY|Регистрация(регистратура)
REGRET|жалеть
REGULAR|регулярный
REGULARLY|регулярно
REGULATE|регулировать, приспосабливать
REHEARSAL|репетиция
REIGN|царить, господствовать
REINS|поводья, вожжи
REJECT|отвергать
REJECTION|отказ
REJOICE|радовать(ся)
REJOINED|Воссоединенный
RELATE|относиться, связывать
RELATION|отношение, связь
RELATIONS|отношения, связи (от relation)
RELATIONSHIP|родственные связи
RELATIVE|родственник
RELAX|ослаблять
RELAY|смена (не shift)
RELEASE|освобождение, освобождать
RELEASED|освобожденный
RELIABLE|надежный
RELIANCE|доверие, уверенность
RELIC|след, остаток, пережиток
RELIEF|облегчение, утешение
RELIEVE|облегчать
RELIEVED|избавленный 
RELIGION|религия
RELIGIOUS|религиозный
RELISH|вкус, привкус, смаковать
RELUCTANT|делающий что-л. с большой неохотой, по принуждению; сопротивляющийся
RELUCTANTLY|неохотно (не unwillingly)
RELY|полагаться, доверять
REMAIN|оставаться
REMAINDER|остаток
REMAINED|оставшийся 
REMAINS|Остается
REMARK|замечать, замечание (не notice)
REMARKABLE|замечательный  r-
REMARKABLY|замечательно -y
REMARKS|Замечания *e-
REMEDY|лекарство
REMEMBER|помнить
REMEMBERED|помнил (от remember)
REMEMBRANCE|воспоминание, память
REMIND|напоминать, напомнить
REMISS|небрежный, вялый
REMOTE|дистанционный, удаленный
REMOVAL|перемещение r-
REMOVE|удалять, убирать, перемещать
REMOVED|удалённый 
RENAMED|Переименованный
RENDER|отдавать
RENDERED|Предоставленный (не supplied)
RENEW|обновлять
RENEWAL|обновление (не refresh)
RENEWED|Возобновленный (не resumed)
RENT|брать напрокат, снимать жилье, квартирная плата
RENTING|аренда, снятие комнаты -ing
REOPEN|возобновлять (не resume)
REPAIR|ремонтировать, ремонт, починка
REPAIRED|ремонтировал, отремонтированный (от repair)
REPAY|оплачивать
REPEAT|твердить, говорить наизусть
REPEATEDLY|неоднократно
REPEL|отталкивать, внушать отвращение
REPENT|раскаиваться
REPENTANCE|раскаяние
REPETITION|повторение
REPLACE|заменять, замещать
REPLACEMENT|замещение
REPLY|отвечать, ответ
REPORT|доклад, сообщать, рассказывать
REPORTER|репортер
REPORTING|Сообщение -ing
REPOSE|полагаться, доверяться
REPRESENT|изображать, представлять
REPRESENTATION|изображение
REPRESENTATIVE|представитель
REPROACH|упрек, осуждение, упрекать
REPRODUCE|воспроизводить
REPROOF|порицание, выговор (не reprove)
REPROVE|порицать, делать выговор
REPTILE|пресмыкающееся
REPUBLIC|республика
REPULSE|отражать (врага), отвергать, отталкивать, отпор
REPUTATION|репутация
REQUEST|просьба
REQUESTED|Требуемый
REQUESTS|просьбы (от request)
REQUIRE|требовать
REQUIRED|потребованный (не demanded) 
REQUIREMENT|требование
REQUIRES|Требует
RESCUE|спасение, спасать
RESEARCH|исследование
RESEMBLANCE|сходство
RESEMBLE|походить
RESENT|обижаться, возмущаться *e-
RESENTMENT|возмущение
RESERVATION|предварительный заказ, резервирование
RESERVE|заказывать
RESERVED|заказал, заказанный (от reserve)
RESERVOIR|резервуар
RESIDE|жить, проживать (r-)
RESIDENCE|резиденция
RESIDENT|постоянный житель
RESIDENTIAL|жилой
RESIGN|уходить в отставку
RESIGNATION|отставка, заявление об отставке, покорность, смирение
RESIGNED|покорный, безропотный **s-
RESIST|сопротивляться
RESISTANCE|сопротивление
RESOLUTION|решение, резолюция, решимость
RESOLVE|решать
RESOLVED|решился, принял решение 
RESORT|обращение, обращаться
RESOURCE|ресурс, средство
RESOURCES|Ресурсы
RESPECT|уважение, уважать
RESPECTABLE|почтенный, порядочный
RESPECTED|Уважаемый
RESPECTFUL|почтительный
RESPECTIVE|соответственный
RESPECTIVELY|соответственно
RESPOND|отвечать
RESPONDED|Отвечал
RESPONSE|реакция, ответ (не reaction)
RESPONSIBILITY|ответственность
RESPONSIBLE|ответственный
RESPONSIVE|отзывчивый
REST|остальное, остальные, остаток
RESTART|Переначало
RESTAURANT|ресторан
RESTED|отдыхал (от rest)
RESTLESS|беспокойный, неугомонный
RESTORATION|реставрация
RESTORE|восстанавливать
RESTRAIN|сдерживать
RESTRICT|ограничивать
RESTRICTION|ограничение
RESTRICTIONS|ограничения (от restriction)
RESULT|результат
RESUME|итог, сводка, возобновлять, подводить итог
RESUMED|Возобновленный
RETAIN|удерживать
RETAINED|Сохраненный
RETIRE|уходить, удаляться, оставлять должность
RETIRED|отставной
RETIREMENT|отставка
RETIRING|скромный r-
RETORTED|Парировал
RETREAT|отступать, отступление, убежище
RETURN|вернуть(ся), возвращение
REV|оборот
REVEAL|обнаруживать r-
REVEALED|Показанный
REVENGE|месть, мстить
REVENUE|доход
REVERENCE|почтение, благоговение (не deference)
REVERSE|противоположное, обратное r-
REVERSION|Возвращение (не returning)
REVERT|возвращаться (не return)
REVIEW|обзор, смотр (не survey)
REVISION|пересмотр
REVIVE|оживать
REVOLUTION|революция
REVOLUTIONARY|революционный, революционер
REVOLVE|вращаться
REWARD|награда
REX|Рекс
RHINOCEROS|носорог
RHYME|рифма, рифмовать
RHYTHM|ритм
RIB|ребро (не hip)
RIBBON|лента
RICE|рис
RICH|богатый
RICHARD|Ричард
RICHES|богатство, изобилие
RICK|стог, складывать в стог
RID|освобождать
RIDDLE|загадка (не enigma)
RIDE|езда, прогулка (не пешая), ехать (на поезде, велосипеде и т.п.)
RIDER|наездник, всадник
RIDGE|горный хребет, гребень (горы и т.п.) (не crest)
RIDICULOUS|нелепый, смехотворный, смешной
RIDING|еду (от ride), верховая езда
RIFLE|ружье, винтовка
RIFT|трещина, щель, ущелье
RIG|снаряжение, экипаж
RIGHT|правильный, правый
RIGHTLY|справедливо r-
RIGID|жесткий (не tough)
RIGOROUS|суровый (не severely) r-
RIM|ободок
RIND|кожура, кора, корка (не pool)
RING|кольцо, звон, звонок, звенеть, звонить
RINGS|Кольца
RIP|рвать
RIPE|спелый
RIPEN|зреть, созревать
RISE|подниматься, восходить, подъем, повышение
RISEN|Повышенный
RISING|возрастающий
RISK|риск, рисковать
RIVAL|соперник, соперничающий
RIVER|река
RIVERS|Реки
RIVULET|ручеек, речушка
ROAD|дорога
ROAM|бродить, скитаться
ROAR|реветь, орать, хохотать
ROAST|жареный
ROB|грабить, обворовывать
ROBBER|грабитель
ROBBERY|грабеж
ROBES|Одежды
ROBIN|малиновка
ROBOT|Робот
ROBOTS|Роботы
ROCHESTER|Рочестер
ROCK|скала
ROCKY|скалистый 
ROD|прут, жезл, удочка
RODE|ехать (2 форма) 
ROGUE|плут, мошенник (не valet)
ROLE|роль
ROLL|вращение, список, булочка, вращаться, катить(ся)
ROLLBACK|Обратная перемотка
ROLLER|ролик
ROMAN|Католик
ROMANCE|романтика, романтическая история
ROMANTIC|романтичный
ROME|Рим
RON|Рон
ROOF|крыша
ROOM|комната
ROOMS|комнаты (от room)
ROOT|корень
ROPE|канат
ROPES|Веревки
ROSE|роза
ROSY|розовый, румяный (не pink)
ROT|вздор, нелепость
ROTTEN|гнилой, отвратительный
ROUGE|румяна, губная помада
ROUGH|грубый
ROUND|круг, цикл, полный, круглый
ROUNDED|Округленный
ROUSE|будить, побуждать (первая буква НЕ a)
ROUSED|Разбуженный (не awoken)
ROUTE|маршрут, путь, направлять
ROVER|скиталец, странник
ROW|грести
ROWING|гребля, выговор
ROYAL|королевский (не queen)
RPM|Оборот в минуту
RUB|тереть, стирать, трение
RUBBER|резина
RUBBING|Протирка (не от слова wash) -ing
RUBBISH|ерунда, мусор (не garbage)
RUBY|рубиновый
RUDDER|руль
RUDE|грубый, резкий, невоспитанный
RUDIMENTARY|Элементарный(рудиментарный)
RUEFUL|унылый
RUFFLE|ерошить (волосы), рябить (воду)
RUG|ковер
RUIN|гибель
RUINS|Руины
RULE|правило, принцип, норма, управлять, решать
RULER|линейка, правитель
RULES|правила (от rule)
RULING|правящий (-ing)
RUM|ром, странный
RUMOUR|слух, молва
RUN|бегать, двигаться, бег, движение, направление
RUNG|ступенька, спица колеса
RUNNER|бегун
RUNNERS|Бегуны
RUNNING|пробег, бегущий
RUNS|Пробега
RUSE|уловка, хитрость
RUSH|устремляться, бросаться, мчаться
RUSSELL|Русселл
RUSSIA|Россия
RUSSIAN|русский
RUST|ржавчина, ржаветь
RUSTLE|шелест, шорох, шелестеть, шуршать r-
RUSTY|заржавленный, порыжевший
RUT|колея, привычка
RUTH|жалость, сочувствие, участие, сострадание *u- 
RYE|рожь
SABOTAGE|саботаж, саботировать
SACK|мешок
SACRED|священный
SACRIFICE|жертва
SAD|печальный
SADDLE|седло, седлать
SADLY|печально
SADNESS|печаль
SAFE|сейф, безопасный, надежный
SAFEGUARD|гарантия s-
SAFETY|безопасность
SAID|сказал (от say)
SAIL|парус, плыть
SAILOR|матрос
SAINT|святой
SAKE|ради, для
SALAD|салат, винегрет
SALARY|оклад
SALE|распродажа
SALLY|поездка, прогулка
SALMON|лосось
SALT|соль, соленый, солить
SALTS|Соли
SALUTE|приветствовать, салют
SALVAGE|спасать 
SALVATION|спасение
SAM|Сэм
SAME|тот же, так(ой) же
SAMPLE|образец
SANCTION|санкция
SAND|песок
SANDWICH|бутерброд
SANDWICHES|Бутерброды
SANDY|песчаный
SANG|пел, спел (от sing)
SANGUINE|живой, жизнерадостный, румяный (не spirited)
SANK|тонул 
SANTOS|Сантус
SAP|сок (растений); подрывать
SAT|сидел (от sit)
SATISFACTION|удовлетворение
SATISFACTORILY|удовлетворительно
SATISFACTORY|удовлетворительный
SATISFY|удовлетворять
SATURDAY|суббота
SAUCE|соус, приправа, поливать соусом
SAUCEPAN|кастрюля
SAUCER|блюдце
SAUSAGE|колбаса, сосиска
SAVAGE|дикарь
SAVAGELY|свирепо, дико s-
SAVE|спасать, хранить, экономить
SAVED|спасал (от save)
SAVING|экономия -ing
SAVIOUR|спаситель
SAVOURY|вкусный, пикантный, приятный
SAW|видел, смотрел (от see)
SAY|сказать, говорить
SAYING|говорящий (от say)
SCAFFOLD|эшафот
SCALE|масштаб
SCAN|Просмотр
SCAR|шрам, рубец
SCARCE|редкий, едва (не barely, merely, hardly)
SCARCELY|едва sc-
SCARE|испуг
SCARED|напуганный 
SCARF|шарф
SCARLET|алый
SCATTER|разбрасывать, рассеивать
SCATTERED|Разбросанный, раскиданный
SCENE|действие, картина, сцена
SCENERY|декорации
SCENES|сцены, эпизоды (от scene)
SCENT|запах, духи, след, почуять, нюхать (не smell)
SCHEDULE|расписание, таблица, планировать
SCHEME|проект
SCHEMES|Схемы
SCHOLAR|ученый
SCHOLARS|Ученые
SCHOOL|школа, обучать
SCHOOLBOY|школьник
SCHOOLMASTER|учитель
SCIENCE|наука, умение
SCIENTIFIC|научный
SCIENTIST|ученый
SCISSORS|ножницы
SCOLD|бранить, ругать
SCOPE|пределы
SCORE|счет, отметка, выигрывать
SCORN|презрение, презирать
SCORNFUL|презрительный
SCOTCH|надрез, метка, уничтожать
SCOUNDREL|негодяй
SCOUT|разведчик
SCOWLED|Хмурился (не от слова frown)
SCRAMBLE|карабкаться
SCRAMBLED|Боролся(взбирался)
SCRAP|клочок, кусочек, отрывок
SCRATCH|царапать
SCRATCHED|Поцарапанный
SCREAM|вскрикнуть, зареветь, визг, вопль (не shriek)
SCREEN|экран, перегородка, прикрывать
SCREW|привинчивать, завинчивать, принуждать, винт
SCRIBBLE|каракули, писать неразборчиво
SCRIPT|сценарий
SCRIPTS|Подлинники(сценарии)
SCRUB|тереть
SCUBA|Акваланг
SCUFFLE|драка, потасовка
SCULPTURE|скульптура
SEA|море, океан
SEAL|печать, запечатывать
SEAM|шов
SEAMAN|моряк *e-
SEARCH|искать, обыскивать, поиск, обыск
SEASICK|страдающий морской болезнью
SEASIDE|морское побережье
SEASON|время года, сезон, созревать
SEAT|место, сиденье, сажать, усаживать
SEATED|Помещенный
SEATS|места (от seat)
SEAWEED|Морская водоросль
SECOND|второй, помощник, секунда
SECONDARY|средний, второстепенный
SECONDLY|Во-вторых
SECRET|секрет
SECRETARY|секретарь
SECRETION|Укрывательство
SECTION|отделение, делить на части s-
SECURE|страховать s-
SECURITY|безопасность
SEDATE|спокойный
SEE|(у)видеть, встретиться
SEED|семя, семена
SEEDLING|Рассада
SEEDLINGS|Рассада
SEEDS|Семена
SEEING|видящий (от see)
SEEK|искать (не find)
SEEM|казаться
SEEMING|видимый, мнимый (не visible)
SEEN|увиденный (от see)
SEGMENT|Доля (не portion, section)
SEIZE|хватать -e
SEIZED|захваченный 
SELDOM|редко
SELECT|выбирать, сортировать, избранный
SELECTED|Отобранный
SELECTION|отбор
SELF|сам, себя
SELFISH|эгоистичный
SELL|продавать, торговать
SELLER|торговец (не trader)
SELLING|продажа
SEMI|Полу
SEMICOLON|точка с запятой
SEND|отправлять, посылать
SENIOR|старший s-
SENSATION|чувство s-
SENSE|чувство, здравый смысл, чувствовать
SENSES|Чувства
SENSIBLE|разумный
SENSITIVE|чувствительный
SENSITIVENESS|Чувствительность
SENT|отправил, послал, отправленный, посланный (от send)
SENTENCE|предложение s-
SENTIMENT|настроение
SENTIMENTS|Чувства
SEPARATE|отдельный
SEPARATED|Отделенный
SEPARATION|отделение, разделение
SEPTEMBER|сентябрь
SEQUEL|продолжение, результат
SEQUENCE|последовательность
SERGEANT|сержант
SERIES|серия
SERIOUS|серьезный
SERIOUSLY|серьезно
SERMON|проповедь
SERPENT|змея, змей
SERVANT|слуга
SERVE|служить, обслуживать, подавать
SERVER|Прислуга
SERVERS|Прислуга
SERVICE|сервис, обслуживание
SERVICES|Услуги
SERVING|порция s-ing
SESSION|заседание (не sitting)
SET|класть, ставить, помещать, комплект
SETS|декорации (от set)
SETTING|окружение -ing
SETTLE|поселять, устраивать, оплачивать
SETTLEMENT|поселение
SEVEN|семь
SEVENTEEN|семнадцать
SEVENTH|седьмой
SEVENTY|семьдесят
SEVERAL|несколько
SEVERE|суровый, жестокий (s-)
SEVERELY|строго (*e-)
SEW|шить
SEX|пол
SEXUAL|сексуальный
SHABBY|потрепанный, поношенный
SHADE|оттенок, тень, затенять
SHADES|оттенки (от shade)
SHADOW|тень, покров, заслонять
SHADY|тенистый, сомнительный, темный
SHAFT|древко, ручка, рукоятка, вал (тех.)
SHAGGY|лохматый
SHAKE|пожать (руки), дрожать, трясти
SHALL|модальный глагол долженствования
SHALLOW|мелкий, поверхностный, (от)мель
SHAM|притворство, обман
SHAME|стыд, стыдить, стыдиться
SHAPE|форма
SHAPED|Форменный
SHAPELESS|бесформенный
SHARE|разделять, доля, часть
SHARK|акула
SHARP|точно, ровно, резкий, крутой, плутовать
SHARPEN|точить
SHARPLY|резко
SHAVE|(по)бриться, бритье, подстригать
SHAVING|бритье (-ing)
SHAWL|платок, шаль
SHE|она
SHED|сарай
SHEEP|овца, овцы
SHEER|настоящий
SHEET|простыня, лист, пласт
SHELF|полка
SHELL|раковина, скорлупа
SHELLS|Снаряды(раковины)
SHELTER|приют, убежище
SHELVES|Полки
SHEPHERD|пастух
SHERIFF|Шериф
SHIELD|щит
SHIFT|смена, перемещать
SHILLING|шиллинг
SHINDY|шум, скандал
SHINE|сиять, светить
SHINY|Солнечный (не sunny)
SHIP|корабль, пароход, грузить, перевозить
SHIPWRECK|кораблекрушение
SHIRT|рубашка, блузка
SHIVER|дрожать, дрожь, трепет s-
SHOCK|удар s-
SHOCKING|потрясающий
SHOE|ботинок, туфля
SHOEMAKER|сапожник
SHOES|обувь, туфли (от shoe)
SHONE|сиял, блестел 
SHOOK|трёс 
SHOOT|стрелять, застрелить
SHOOTING|Стрельба
SHOP|магазин, мастерская
SHOPPING|делать покупки
SHOPS|магазины (от shop)
SHORE|берег
SHORT|короткий, слабый, внезапно
SHORTER|короче (от short)
SHORTEST|ближайший, самый короткий (от short)
SHORTHAND|стенография
SHORTLY|вскоре
SHORTS|трусики
SHOT|попытка, выстрел
SHOULD|следует (от shall)
SHOULDER|плечо, толкать
SHOUT|кричать, крик
SHOVE|толкать(ся), пихать, толчок
SHOVED|Пихал (не popped)
SHOVEL|лопата
SHOW|показывать, демонстрировать, выставка, зрелище
SHOWED|показал (от show)
SHOWER|душ, ливень
SHOWN|Показанным
SHREWD|проницательный, ловкий (делец)
SHRIEK|кричать, вскрикнуть, пронзительный крик (не scream)
SHRILL|резкий, пронзительный
SHRIMP|креветка
SHRINE|сохранять
SHRINK|отпрянуть, садиться (о материи)
SHRUB|куст
SHRUBS|кусты (не bushes) 
SHRUG|пожимать плечами
SHRUGGED|Пожал
SHUDDER|дрожь, вздрагивать; содрогаться
SHUFFLE|шаркать
SHUT|закрывать, запирать, замолчать
SHUTDOWN|Закрытие
SHUTTER|ставень, затвор
SHY|застенчивый, робкий
SIBILANT|шипящий звук
SICK|больной
SICKLY|болезненный, нездоровый, тошнотворный
SICKNESS|болезнь, заболевание
SIDE|сторона, бок, край
SIDENOTE|Заметка на полях
SIDEWAYS|боком, косвенно
SIERRA|горная цепь
SIEVE|решето, сито
SIGH|вздыхать, вздох
SIGHT|зрелище, вид, заметить, разглядеть
SIGHTS|достопримечательности
SIGN|подписывать(ся), знак, вывеска
SIGNAL|сигнал, сигнализировать
SIGNATURE|подпись
SIGNED|Подписанный
SIGNIFICANCE|значение
SIGNIFICANT|значительный s-
SIGNIFICANTLY|значительно
SIGNIFY|значить, означать, иметь значение
SIGNS|знаки, вывески (от sign)
SILAS|Силас
SILENCE|молчание, тишина
SILENT|молчаливый, бесшумный
SILK|шелковый, шелк
SILL|подоконник
SILLY|глупый
SILVER|серебро, серебряный
SIMILAR|похожий
SIMILARLY|также
SIMPLE|простой, однозначный
SIMPLICITY|Простота (-t*)
SIMPLY|просто, абсолютно
SIMULATOR|симулянт
SIMULTANEOUS|одновременный
SIMULTANEOUSLY|одновременно
SIN|грех, (со)грешить
SINCE|с тех пор как
SINCERE|искренний (-e)
SINCERELY|Искренне (не earnestly)
SING|пение, петь
SINGING|Пение
SINGLE|один, одинокий s-
SINGULAR|странный, необычный, единственное число (грам.)
SINISTER|зловещий s-
SINK|тонуть
SINKING|погружение
SIR|сэр
SIRE|Родитель
SISTER|сестра
SIT|сидеть, заседать, годиться
SITE|местоположение
SITTING|заседание
SITUATED|расположенный
SITUATION|положение
SIX|шесть
SIXPENCE|сумма в 6 пенсов
SIXTEEN|шестнадцать
SIXTH|шестой
SIXTY|шестьдесят
SIZE|размер, величина, измерить
SKELETON|скелет, остов
SKETCH|эскиз
SKI|ходить на лыжах
SKIING|катание на лыжах
SKILFUL|квалифицированный, умелый, ловкий
SKILL|мастерство
SKILLED|квалифицированный, умелый, ловкий
SKIM|просматривать, скользить
SKIN|кожа
SKINNER|погонщик 
SKINNY|худой, тощий, кожа да кости 
SKINS|Кожи
SKIP|пропускать (часто бывает при устано 
SKIRT|юбка
SKULL|череп
SKY|небо
SLAB|плита
SLACK|ленивый, слабый, ослаблять, утихать
SLACKEN|ослаблять, ослабевать
SLAM|хлопать, хлопнуть -m
SLAMMED|Хлопнул
SLANG|жаргон
SLANT|наклонный
SLAP|хлопать
SLAUGHTER|резня, убой, резать, убивать
SLAVE|раб
SLAVES|рабы 
SLEDGE|ехать на санях
SLEEK|гладкий, приглаживать
SLEEP|спать, сон
SLEEPY|сонный, сонливый (не asleep)
SLEEVE|рукав
SLEIGH|сани, салазки
SLENDER|тонкий, стройный
SLEPT|спал (от sleep)
SLICE|ломоть
SLID|скользить (не slip) 
SLIDE|скользить
SLIGHT|проявление пренебрежительного равнодушия;неуважение, пренебрежение, игнорирование
SLIGHTEST|малейший (от slight)
SLIGHTLY|слегка
SLIM|стройный
SLIME|слизь, липкая грязь, ил; комбинация (белье)
SLIP|скольжение, скользить -p
SLIPPERY|скользкий
SLOGAN|лозунг
SLOPE|склон, наклон, гора для катания
SLOW|медленный, замедлять
SLOWER|медленнее (от slow)
SLOWLY|медленно
SLUMBER|сон, дремота, дремать
SLY|хитрый
SMACK|рыболовное судно
SMALL|маленький, тонкий, скромный
SMALLEST|Самый маленький
SMART|изящный (не grace)
SMARTLY|ловко
SMASH|бить, разбивать
SMASHED|Разбитый
SMEAR|масляное пятно, пачкать, мазать
SMELL|запах
SMELT|плавить
SMILE|улыбаться, улыбка
SMILES|Улыбки
SMOKE|курить, курение, дым
SMOKED|курил (от smoke)
SMOKER|курящий, вагон для курящих
SMOKING|курение
SMOOTH|гладкий
SMOOTHLY|гладко 
SNACK|закуска, часть, доля
SNAKE|змея
SNAP|щелкать (snap)
SNAPPED|Сфотографированный
SNARE|ловушка
SNARL|рычать, огрызаться; рычание, ворчание
SNATCH|схватить
SNEER|усмешка, насмешка; насмехаться, издеваться
SNEEZE|чихать, чиханье
SNIFF|фыркать, сопеть
SNIFFED|Фыркал
SNIFFING|Фыркающий
SNIGGER|хихикать, хихиканье s-
SNOOP|подсматривать 
SNORE|храпеть, храп
SNORTED|Фыркал (не от слова sniff)
SNOW|снег, падать (о снеге)
SNOWMAN|снежная баба
SNUFF|Нюхнуть
SO|так, таким образом, итак
SOAP|мыло
SOB|рыдание
SOBBING|Рыдание
SOBER|трезвый
SOCIABLE|общительный
SOCIAL|общественный
SOCIETY|общество
SOCK|носок
SOCKET|патрон (эл. лампочки), глазная впадина
SOCKS|носки (от sock)
SOFA|диван
SOFT|мягкий, тихий (не calm)
SOFTEN|смягчать(ся)
SOFTENED|Смягченный
SOFTLY|мягко, нежно
SOFTWARE|Программное обеспечение
SOIL|почва
SOLD|продавал, проданный (от sell)
SOLDER|паять
SOLDIER|солдат
SOLE|подошва, подметка; ставить подметку
SOLELY|Исключительно
SOLEMN|серьезный, торжественный
SOLEMNLY|торжественно
SOLID|твердый
SOLITARY|одинокий, уединенный
SOLITUDE|одиночество, уединение
SOLUTION|решение, разрешение
SOLVE|(раз)решать
SOME|немного, несколько
SOMEHOW|как-нибудь, так или иначе 
SOMETIMES|иногда
SOMEWHAT|что-то, отчасти 
SOMEWHERE|где-нибудь 
SON|сын
SONG|песня
SONS|сыновья (от son)
SOON|скоро, рано
SOONER|охотнее (от soon)
SOOT|сажа
SOOTHE|успокаивать, утешать, облегчать (боль)
SOOTHING|Успокаивающий -ing
SOPHIA|София
SOPHISTICATED|сложный
SORE|больной, воспаленный (не sick)
SORROW|печаль
SORROWFUL|печальный, скорбный
SORRY|сожалеющий, печальный, унылый
SORT|сорт, род, вид, сортировать
SORTING|Сортировка
SOUGHT|Искавший(разысканный)
SOUL|душа, воплощение
SOULS|Души
SOUND|звук, звучать, играть
SOUNDING|звучащий
SOUNDS|звучит (от sound)
SOUP|суп
SOUR|раздражительный, сердитый, кислый
SOURCE|источник
SOUTH|юг
SOUTHERN|южный
SOUVENIR|сувенир
SOUVENIRS|сувениры (от souvenir)
SOVEREIGN|суверенный
SOVIET|Советский
SOW|сеять
SPACE|пространство, место, космос
SPACIOUS|просторный, обширный
SPADE|лопата, заступ
SPARE|уделять, лишний, запасный
SPARED|Сэкономленный
SPARK|искра
SPARKLE|сверкать, искриться
SPARKLER|Бриллиант
SPARROW|воробей
SPASMODIC|судорожный
SPAT|размолвка, звонкий удар
SPEAK|говорить, убеждать
SPEAKER|оратор
SPEAKING|говоря(щий) (от speak)
SPEAKS|Говорит
SPEAR|дротик, копье
SPECIAL|специальный, особенный
SPECIALIST|специалист
SPECIALITY|фирменное блюдо
SPECIALIZE|специализировать
SPECIALLY|особенно
SPECIES|порода
SPECIFIC|специфический
SPECIFICALLY|специфически
SPECIFICATION|Спецификация
SPECIFIED|Указанный
SPECIFY|точно определять, устанавливать, предписывать; детально излагать
SPECIMEN|образец
SPECIMENS|Экземпляры, образцы
SPECTACLE|зрелище
SPECTACLES|очки
SPECTACULAR|производящий глубокое впечатление; впечатляющий; эффектный
SPECULATION|размышление
SPEECH|речь
SPEECHLESS|безмолвный
SPEED|скорость, ускорять, спешить
SPEEDILY|быстро
SPEEDOMETER|спидометр
SPEEDY|быстрый, скорый
SPELL|писать или произносить (слово) по буквам
SPELLING|орфография, правописание
SPEND|тратить
SPENDS|проводит (время) (от spend)
SPENT|проводил, тратил, проведенный, потраченный (от spend)
SPHERE|сфера
SPIDER|паук
SPIDERS|Пауки
SPIKE|острие 
SPILL|проливать(ся), рассыпать(ся)
SPIN|прясть, крутить(ся)
SPINE|позвоночный столб
SPIRIT|дух
SPIRITED|живой, бойкий
SPIRITS|души 
SPIT|плеваться, фыркать
SPITE|злость
SPITEFUL|злобный
SPLASH|брызгать(ся), забрызгать, плескать(ся); плеск, брызги
SPLENDID|замечательно
SPLINTER|щепка, осколок, заноза
SPLIT|раскалывать
SPOIL|портить, баловать
SPOKE|говорил, говоривший (от speak)
SPOKEN|сказанный 
SPONSORSHIP|попечительство
SPOON|ложка
SPOONS|ложки (от spoon)
SPORT|спорт, заниматься спортом
SPORTING|спортивный (-ing)
SPORTS|спорт, спортивные соревнования (от sport)
SPORTSMAN|спортсмен
SPOT|пятно
SPOTLESS|безупречный
SPOTS|Пятна(места)
SPOTTED|Определенный *p-
SPOUT|носик (посуды), желоб
SPRANG|Прыгал (от слова spring)
SPRAY|брызги, обрызгивать
SPREAD|распространяться
SPREADING|Распространение -ing
SPREE|веселье, шалость *p-
SPRING|весна
SPROUT|пускать ростки; отросток, побег
SPRUCE|Ель
SPRUNG|Прыгал (от слова spring)
SPUR|стимул
SPURT|бить струей, делать внезапное усилие
SPY|шпион, шпионить
SQUAD|команда
SQUADRON|эскадрон, эскадра (мор.)
SQUALL|писк, визг
SQUARE|площадь, квадратный
SQUEAL|Визг -a*
SQUEEZE|выжимать, сжимать, давить, впихивать, сжатие, давка
SQUEEZED|Сжатый
SQUINT|косоглазие, косить (о глазах)
SQUIRREL|белка
ST|C-
STABILITY|устойчивость
STABLE|конюшня
STACK|стог, куча, груда
STADIUM|стадион
STAFF|штат, персонал, штаб
STAGE|сцена, эстрада, ставить
STAGGER|шатание, шатать
STAGGERED|Пораженный *t-
STAIN|пятно, пятнать, пачкать
STAIR|лестница
STAIRCASE|лестница
STAKE|ставка, делать ставку
STALE|черствый, затхлый
STALK|стебель
STALL|партер
STALLS|кресла в партере ( от stall)
STAMMER|заикаться, запинаться
STAMP|марка, печать, штемпелевать
STAMPS|марки (от stamp)
STAND|остановка, позиция, стенд, киоск, стоять, останавливаться
STANDARD|стандарт
STANDING|репутация, вес, положение в обществе, стоящий (-ing)
STANDSTILL|застой (не stagnation)
STAR|звезда
STARE|пристальный взгляд
STARED|пристальный 
STARLING|скворец
START|начинать, отправляться s-
STARTER|стартер
STARTLE|испугать, сильно удивить
STARTS|Запуски
STARVE|умирать от голода
STATE|государство, состояние
STATED|зафиксированный, высказанный, изложенный Заявленный
STATELY|величавый, величественный
STATEMENT|утверждение, заявление
STATEMENTS|Утверждения(заявления)
STATES|Государства
STATESMAN|государственный деятель
STATION|станция, место, размещать
STATIONERY|писчебумажные принадлежности
STATISTICS|статистика
STATUE|статуя, памятник
STATURE|рост *t-
STATUS|статус
STATUTE|закон, устав
STAY|оставаться, жить (временно)
STAYED|остался (от stay)
STAYING|остающийся, живущий (от stay)
STEADILY|неуклонно
STEADY|прочный
STEAK|бифштекс
STEAL|(с)воровать
STEALING|Кража
STEAM|пар
STEEL|сталь
STEEP|крутой (не sharp)
STEER|править (рулём)
STEM|стержень
STEMS|Стебли
STEP|шаг, шагать (step)
STEPFATHER|отчим
STEPHEN|Стивен
STERILE|бесплодный 
STERILITY|Бесплодие
STERN|строгий
STERNLY|строго 
STEVE|Стив
STEW|тушеное мясо
STICK|палка, приставать
STICKING|торчащий, приклеенный (-ing) 
STICKS|Палки
STICKY|липкий, клейкий
STIFF|негнущийся, застывший, холодный, натянутый
STIFFEN|(о)коченеть, (о)деревенеть
STILL|все еще, однако, тихий
STIR|суета, суматоха, мешать, помешивать, волновать
STITCH|стежок, петля (в вязании), шить
STOCK|запас, снабжать (не spare, hoard)
STOCKING|чулок
STOCKINGS|чулки (от stocking)
STOCKS|Акции(запасы)
STOCKY|коренастый, низкий, приземистый 
STOLEN|украденный (от steal)
STOMACH|живот, желудок
STONE|камень
STOOL|табуретка
STOOP|наклонять(ся), нагибать(ся), сутулиться, горбиться
STOOPED|Наклоненный
STOP|остановка, перестать, остановиться
STOPPAGE|остановка, задержка
STOPPED|остановились (от stop)
STOPPER|пробка, затычка
STOPS|остановки (от stop)
STORAGE|хранение *t-
STORE|магазин, имущество, запасать, снабжать
STORED|Запасенный
STOREY|этаж
STORIES|истории, рассказы (от story)
STORK|аист
STORM|буря, взрыв (не blast)
STORMY|бурный
STORY|рассказ, история
STOUT|тучный, дородный
STOVE|печь, плита
STRAIGHT|прямо, сразу, прямой, достоверный s-
STRAIGHTEN|выпрямлять(ся)
STRAIGHTENED|Выправляемый
STRAIGHTFORWARD|прямой
STRAIN|натягивать, напрягать(ся), напряжение
STRAIT|узкий, пролив, затруднительное материальное положение, нужда
STRANGE|странный
STRANGELY|странным образом
STRANGER|незнакомец, иностранец
STRANGERS|Незнакомцы
STRANGLE|задушить
STRAP|ремень, стягивать ремнем
STRATEGY|стратегия
STRAW|пустяк, мелочь
STRAWBERRIES|клубника
STRAWBERRY|земляника
STRAY|сбиваться с пути, заблудившийся
STREAM|ручей, поток
STREET|улица
STRENGTH|численность, сила, прочность
STRENGTHEN|усиливать, укреплять
STRETCH|растягивать, вытягиваться
STRETCHED|растянутый 
STRETCHING|Протяжение
STRICT|точный
STRICTLY|строго *t-
STRIKE|ударять, забастовка
STRIKING|бьющий, ударяющий (от strike)
STRING|вереница, ряд, струна, связывать
STRINGS|Вереницы(нити) (не threads)
STRIP|полоса
STRIPED|полосатый
STRIPES|Полосы
STRODE|походка, большой шаг (прошедшее время) 
STROKE|удар, гладить *t
STROLL|прогулка, гулять
STRONG|сильный
STRONGEST|Самый сильный
STRONGHOLD|крепость, оплот
STRONGLY|решительно (первая буква НЕ "d")
STRUCK|забастовка, удар (прошедшее время) 
STRUCTURE|структура
STRUGGLE|бороться, борьба
STRUGGLING|Борьба
STUBBORN|упрямый
STUCK|воткнул, приклеил 
STUD|запонка
STUDENT|студент
STUDENTS|студенты (от student)
STUDIED|учился (от study)
STUDIO|студия
STUDIOUS|прилежный s-
STUDY|учиться, изучать, заниматься, исследование, кабинет
STUDYING|занимается (от study)
STUFF|вещество, материал, заполнять, набивать
STUFFED|Наполненный
STUFFY|душный
STUMBLED|Наткнулся
STUMP|пень
STUN|оглушать
STUPID|глупый
STYLE|стиль, фасон, прическа
SUBDUED|подавленный
SUBJECT|предмет, содержание, подчинять
SUBJECTED|Подвергнутый *u-
SUBJECTS|предметы (от subject)
SUBMARINE|подводная лодка
SUBMIT|подчиняться
SUBQUERIES|Подвопросы
SUBQUERY|Подвопрос
SUBSCRIBE|подписываться
SUBSCRIBER|подписчик
SUBSCRIPTION|подписка
SUBSEQUENT|последующий (не successive)
SUBSEQUENTLY|впоследствии
SUBSIDED|Спадал
SUBSTANCE|вещество
SUBSTANTIAL|существенный, заметный, прочный, крепкий
SUBSTITUTE|заместитель
SUBTLE|тонкий, неуловимый
SUBURB|пригород, окраина
SUCCEED|достигать цели
SUCCEEDING|Следование -ing
SUCCESS|успех, удача
SUCCESSES|успехи (от success)
SUCCESSFUL|удачный, успешный
SUCCESSFULLY|успешно
SUCCESSION|последовательность
SUCCESSIVE|последующий
SUCCESSOR|преемник
SUCH|такой
SUCK|сосать
SUDDEN|внезапный
SUDDENLY|внезапно, вдруг
SUE|преследовать судебным порядком, возбуждать дело в суде
SUFFER|страдать
SUFFERING|страдание
SUFFICIENT|достаточный
SUFFICIENTLY|достаточно
SUFFIX|суффикс (грам.)
SUFFOCATE|душить, задыхаться
SUGAR|сахар
SUGGEST|предлагать, советовать
SUGGESTED|предлагал, предложенный (от suggest)
SUGGESTION|предложение
SUGGESTIONS|предложения (от suggestion)
SUICIDE|самоубийство, самоубийца
SUIT|костюм, подходить, устраивать
SUITABLE|подходящий, соответствующий (не eligible)
SUITCASE|чемодан
SUITCASES|чемоданы (от suitcase)
SUITE|номер люкс
SUITED|Удовлетворенный
SULKY|мрачный, хмурый **l**
SULPHUR|сера
SULTRY|знойный, душный
SUM|сумма, подводить итог
SUMMARY|конспект, суммарный
SUMMER|лето, летний
SUMMIT|вершина
SUMMON|вызывать
SUMMONED|Вызванный
SUN|солнце
SUNDAY|воскресенье
SUNFLOWER|подсолнух
SUNK|Погруженным
SUNLIGHT|солнечный свет
SUNNY|солнечный
SUNRISE|восход солнца
SUNSET|закат
SUNSHINE|солнечный свет
SUNSTROKE|солнечный удар
SUPERB|превосходный (не pretty)
SUPERFICIAL|поверхностный, внешний
SUPERFLUOUS|излишний, чрезмерный
SUPERINTEND|надзирать (за)
SUPERINTENDENT|управляющий, заведующий
SUPERIOR|высший, лучший
SUPERIORITY|старшинство
SUPERLATIVE|превосходная степень (грам.)
SUPERMARKET|супермаркет
SUPERSERVER|Суперприслуга
SUPERSTITION|суеверие, предрассудки
SUPPER|ужин
SUPPLEMENT|добавление
SUPPLIED|Снабженный
SUPPLIES|Запасы(поставки)
SUPPLY|снабжать
SUPPORT|поддерживать, опора, поддержка
SUPPORTED|Поддержанный
SUPPORTER|сторонник
SUPPORTING|опорный -ing
SUPPOSE|полагать, предполагать
SUPPOSED|предполагаемый (от suppose)
SUPPOSEDLY|предположительно
SUPPRESS|подавлять
SUPPRESSED|Подавленный
SUPREME|верховный, высший
SURE|уверенный, убедиться, безусловно
SURELY|несомненно
SURFACE|поверхность
SURFACES|Поверхности
SURGEON|хирург
SURGERY|хирургия, приемная хирурга
SURLY|угрюмый, неприветливый **r**
SURNAME|фамилия
SURPLUS|излишек
SURPRISE|удивление, удивлять
SURPRISING|удивительный
SURPRISINGLY|удивительно
SURROUND|окружать
SURROUNDING|Окружение
SURROUNDINGS|окрестности, среда, окружение
SURVEY|осмотр
SURVEYED|Рассмотренный
SURVEYING|Рассмотрение -ing
SURVIVE|пережить
SUSAN|Сьюзен
SUSPECT|подозревать
SUSPECTED|Подозреваемый
SUSPEND|приостанавливать
SUSPENDED|приостановленный 
SUSPENSE|неизвестность
SUSPENSION|приостановка, пауза, перерыв
SUSPICION|подозрение
SUSPICIONS|Подозрения
SUSPICIOUS|подозрительный
SUSTAIN|поддерживать (*u-)
SWALLOW|глотать, проглатывать
SWAM|плавал (от swim)
SWAMP|болото, топь s-
SWAN|лебедь
SWARM|рой, толпа; роиться, толпиться (не crowd)
SWAY|качание, взмах
SWEAR|клясться
SWEAT|пот, потеть
SWEATER|эксплуататор
SWEEP|(под)мести s-
SWEET|милый, сладкий, приятный s-
SWEETHEART|возлюбленный(ая), дорогой(ая) (как обращение)
SWEETNESS|Сладость
SWELL|отличный, превосходный
SWELLING|воспаление, отек -ing
SWEPT|подметал 
SWIFT|быстрый (не speed)
SWIFTLY|быстро 
SWIG|потягивать вино
SWIM|плавать
SWIMMER|пловец
SWIMMING|плавание
SWINDLE|обман, обманывать, надувать (не deceive)
SWING|качание, качели, качаться, колебаться
SWITCH|переключать, включать, выключатель, выключать
SWORD|меч, шпага, сабля
SYLLABLE|слог
SYMBOL|символ
SYMPATHETIC|сочувственный
SYMPATHIZE|сочувствовать
SYMPATHY|симпатия, сострадание
SYNTAX|Синтаксис
SYRINGE|шприц
SYSTEM|система
SYSTEMS|Системы
TAB|петелька
TABLE|стол, таблица, расписание
TABLES|Столы
TABLETS|таблетки (от tablet)
TACK|линия, курс (t-)
TACKLE|хватать *a-
TACTICS|тактика
TAG|бирка, ярлык
TAIL|конец, хвост
TAKE|брать, взять, принимать
TAKING|овладение
TALE|повесть, сказка, история
TALENT|талант
TALENTED|талантливый
TALES|сказки, истории (от tale)
TALK|говорить, беседовать
TALKING|беседа
TALL|невероятный, высокий
TALLY|бирка, этикетка, дубликат, копия (не label)
TAME|приручать, приручить, прирученный
TANGERINE|мандарин (плод)
TANGIBLE|осязаемый
TANGLE|сплетение, путаница, запутывать(ся)
TANK|танк, резервуар
TAP|постучать
TAPE|лента, обматывать лентой
TAR|смола, деготь; мазать дегтем, смолить
TARGET|задание
TASK|задача
TASTE|пробовать, иметь вкус
TASTED|пробовал (от taste)
TASTES|имеет вкус (от taste)
TAUGHT|обучал, обученный (от teach)
TAX|налог
TAXI|такси
TEA|чай, отвар
TEACH|обучать, преподавать
TEACHER|учитель
TEACHING|обучение
TEAM|команда
TEAMS|команды (от team)
TEAR|слеза, разрыв, (по)рвать
TEARING|Разрывание -ing
TEARS|слёзы 
TEASE|дразнить, задира
TECHNICAL|технический
TECHNICIAN|специалист t-
TECHNIQUE|техника
TED|раскидывать
TEDDY|Тэдди
TEDIOUS|скучный, утомительный **d****
TEENAGERS|подростки (от teenager)
TEETH|зубы
TELEGRAM|телеграмма
TELEGRAPH|телеграф
TELEPHONE|телефон, звонить по телефону
TELESCOPE|телескоп
TELEVISION|телевидение
TELL|говорить, рассказывать
TELLS|Сообщает
TEMPER|сдержанность, самообладание
TEMPERATURE|температура
TEMPLE|храм
TEMPORARILY|временно
TEMPORARY|временный
TEMPT|искушать
TEMPTATION|искушение, соблазн
TEMPTED|Соблазненный
TEN|десять
TENANT|арендатор, жилец
TEND|иметь тенденцию
TENDENCY|тенденция
TENDER|нежный t-
TENDERLY|нежно, мягко 
TENDERNESS|нежность 
TENNIS|теннис
TENSE|время (грам.)
TENT|палатка
TENTACLES|Щупальца
TENTATIVE|предварительный, предполагаемый; умозрительный, не вполне определенный
TENTH|десятый
TERM|семестр, срок
TERMINAL|конечный пункт
TERMINATE|кончать(ся)
TERMINUS|Конечная остановка
TERMS|личные отношения, условия соглашения
TERRACE|терраса
TERRIBLE|ужасный, страшный
TERRIBLY|ужасно t-
TERRIFIC|потрясающий, ужасающий
TERRIFIED|Испуганный
TERRITORY|территория
TERROR|ужас t-
TEST|анализ, проверка, испытывать
TESTING|испытание
TEXT|текст
TEXTBOOK|учебник
THAN|чем
THANK|благодарить
THANKFUL|благодарный
THANKS|спасибо
THAT|это, тот, та, то
THAW|оттепель
THE|определенный артикль
THEATRE|театр
THEATRES|театры (от theatre)
THEE|Вас
THEFT|кража t-
THEIR|их (на вопрос "чей?")
THEM|их (на вопрос "кого?", "что?")
THEME|тема (не topic)
THEMSELVES|себя, себе
THEN|тогда, потом, затем
THENCE|Отсюда
THEORY|теория
THERE|там, туда, вот
THEREAFTER|после этого; впоследствии (не afterwards) 
THEREBY|таким образом t-
THEREFORE|поэтому, следовательно
THEREUPON|после чего, на что
THESE|эти, это
THEY|они
THICK|толстый, густой
THICKET|Чаща
THIEF|вор
THIMBLE|наперсток, наконечник
THIN|тонкий, худощавый
THING|вещь, предмет
THINGS|вещи, дела (от thing)
THINK|думать, мыслить
THINKING|размышление
THINKS|думает (от think)
THIRD|третий
THIRST|жажда
THIRSTY|испытывающий жажду
THIRTEEN|тринадцать
THIRTEENTH|тринадцатый
THIRTY|тридцать
THIS|этот, это
THOMAS|Томас
THONG|ремень, плеть
THORN|шип, колючка (не prick)
THORNY|колючий, тернистый ****n*
THOROUGH|тщательный
THOROUGHFARE|проход, проезд
THOROUGHLY|тщательно
THORPE|Торп
THOSE|тот, та, то, те
THOU|Вы
THOUGH|хотя, несмотря на
THOUGHT|думал, обдуманный (от think), мысль
THOUGHTFUL|задумчивый, погруженный в размышления
THOUGHTFULLY|внимательно 
THOUGHTLESS|необдуманный, беспечный, эгоистичный
THOUSAND|тысяча
THRASH|молотить, бить
THREAD|нитка
THREAT|угроза
THREATEN|грозить, угрожать
THREATENED|находящийся в угрожаемом положении 
THREATENING|Угроза -ing
THREE|три
THRESHOLD|порог
THREW|бросал (не flung) 
THRICE|трижды
THRILL|волновать
THRILLED|возбуждённый 
THRILLING|захватывающий -ing
THRIVE|преуспевать; буйно, пышно расти
THROAT|горло
THROB|пульсация, пульсировать
THROBBING|пульсация, биение
THRONE|трон
THRONG|толпиться, переполнять
THROUGH|через, сквозь
THROUGHOUT|повсюду, везде, во всех отношениях (не everywhere)
THROW|бросать
THRUST|толчок, удар, толкать
THUMB|большой палец (руки)
THUNDER|гром, греметь
THURSDAY|четверг
THUS|так, таким образом
THY|Ваш
TICKET|билет
TICKETS|билеты (от ticket)
TICKLE|щекотать
TIDE|прилив и отлив
TIDY|чистый, аккуратный, убирать, приводить в порядок
TIDYING|уборка
TIE|связь, связывать, галстук
TIED|связанный 
TIES|связи (от tie)
TIGER|тигр
TIGHT|плотный, крепкий, тугой
TIGHTEN|сжимать (не squeeze)
TILE|черепица, кафель
TILL|до
TIM|Тим
TIMBER|бревно
TIME|время
TIMEOUT|Перерыв
TIMES|раз (от time)
TIMETABLE|расписание
TIMID|робкий, застенчивый
TIN|олово, жестянка, консервная банка
TINKER|Ремесленник
TINKLE|звон, звяканье
TINY|крошечный
TIP|чаевые, давать на "чай", наконечник
TIPS|Наконечники(чаевые)
TIPTOE|кончики пальцев, цыпочки
TIRE|уставать, надоесть
TIRED|усталый (от tire)
TIRESOME|утомительный
TIRING|утомительный t-
TITLE|заглавие, титул
TO|предлог, частица инфинитива
TOAD|жаба
TOAST|тост (жар. хлеб), сушить
TOBACCO|табак
TODAY|сегодня, теперь, современный
TODAY'S|сегодняшний (от today)
TODDLE|ковыляние, прогуливаться
TOE|палец
TOES|Пальцы ноги(носки)
TOFFEE|ириска
TOGETHER|вместе, одновременно
TOIL|трудиться, (тяжелый) труд
TOILET|туалет
TOKEN|признак, примета
TOLD|рассказал, сообщил (от tell)
TOLERABLE|сносный, допустимый
TOLERANT|терпимый (не bearable)
TOLERATE|терпеть
TOMATO|томат, помидор
TOMATOES|помидоры (от tomato)
TOMB|могила, гробница
TOME|Том
TOMMY|Томми
TOMORROW|завтра, назавтра
TON|тонна
TONE|стиль, характер
TONES|Тоны
TONGS|щипцы, клещи
TONGUE|язык
TONIGHT|сегодня вечером
TOO|слишком, тоже
TOOK|брал (от take)
TOOL|инструмент
TOOLS|инструменты 
TOOTH|зуб
TOOTHACHE|зубная боль
TOP|верх, верхушка
TOPIC|тема
TOPMOST|самый верхний, самый важный
TOPPLE|валиться
TORCH|факел
TORCHES|фонарики 
TORE|рвал 
TORN|оборванный (не worn) 
TORRENT|поток
TORTOISE|черепаха
TORTURE|пытать, пытка (не attempt)
TOSS|толчок, сотрясение, кидать, бросать
TOTAL|сумма, весь, полный t-
TOTALLY|полностью
TOUCH|соприкосновение, контакт
TOUCHING|трогательный -ing
TOUGH|жесткий
TOUR|путешествие, тур (не trip)
TOURIST|турист(ский)
TOURNAMENT|турнир
TOW|буксировать, тянуть, тащить
TOWARD|к, на
TOWARDS|к, в направлении
TOWEL|полотенце
TOWER|башня
TOWERS|Башни
TOWN|город (не city)
TOWNS|Города
TOY|игрушка, играть, забавляться
TOYS|игрушки (от toy)
TRACE|следить, чертить
TRACED|Прослеженный
TRACES|Следы
TRACK|след, тропа, колея
TRACKS|Следы
TRADE|торговать, ремесло, занятие, профессия
TRADING|торговля
TRADITIONAL|традиционный
TRADITIONALLY|традиционно
TRAFFIC|уличное движение
TRAGEDY|трагедия
TRAGIC|трагический
TRAIL|след (не trace)
TRAILER|прицеп к автомобилю
TRAIN|поезд, привлекать, воспитывать
TRAINED|обученный
TRAINER|тренер
TRAINING|тренировка, обучение
TRAINS|поезда (от train)
TRAITOR|изменник, предатель
TRAM|трамвай
TRAMP|бродить, громко топать, бродяга
TRANQUILIZER|Транквилизатор
TRANSACTION|дело, сделка, ведение (дел), труды, протоколы (общества) t-
TRANSACTIONS|Сделки
TRANSFER|передача, переносить
TRANSFORMATION|преобразование
TRANSLATE|переводить, объяснять
TRANSLATING|перевести (от translate)
TRANSLATION|перевод
TRANSMISSION|передача
TRANSMITTED|Переданный
TRANSPARENT|прозрачный
TRANSPORT|транспорт, перевозить
TRANSPORTATION|перевозка
TRAP|ловушка, западня
TRAPDOOR|люк
TRAPES|Западни t-
TRAVEL|путешествовать
TRAVELLED|путешествовал, много путешествовавший (от travel)
TRAVELLER|путешественник
TRAVELLING|путешествие, путешествующий -ing
TRAVELS|Путешествия
TRAVERSE|пересекать
TRAY|поднос
TREACHEROUS|предательский, вероломный
TREAD|ступать, наступать
TREASURE|сокровище
TREASURER|Казначей
TREASURES|Сокровища
TREASURY|сокровищница
TREAT|удовольствие, лечить, относиться
TREATED|лечил (от treat)
TREATMENT|обращение, обработка
TREE|дерево (tree)
TREK|поход, переход (не pass)
TREMBLE|дрожать, дрожь
TREMENDOUS|громадный, значительный t-
TREND|общее направление, тенденция
TRESPASS|преступать, нарушать границу (владения)
TRIAL|попытка, испытание
TRIALS|Испытания(суды)
TRIBE|племя, клан
TRIBUTE|дань
TRICE|мгновение
TRICK|хитрость, обман, обманывать (t-)
TRIED|пытался (от try)
TRIFLE|пустяк
TRIFLING|Пустяковый -ing
TRIGGER|курок
TRIGGERS|Спусковые механизмы
TRIM|подрезка, стрижка t-
TRIP|поездка, экскурсия
TRIPLE|тройной
TRIPS|поездки (от trip)
TRIUMPH|триумф
TRIUMPHAL|триумфальный
TRIUMPHANT|торжествующий, победоносный
TROLLEY|тележка
TROOP|войска
TROOPS|войска
TROPHY|трофей
TROPICAL|тропический
TROT|рысь, рысца, бежать рысью
TROUBLE|неприятность, беда, беспокоить(ся), волноваться
TROUBLED|побеспокоил (от trouble)
TROUBLES|неприятности (от trouble)
TROUBLESOME|трудный, неприятный, капризный (о ребенке)
TROUSERS|брюки
TROUT|форель
TRUCK|грузовик t-
TRUE|правильный, верный
TRULY|точно, правдиво, истинно, верно
TRUMPET|труба t-
TRUNK|ствол, туловище
TRUST|доверять, доверие, вера
TRUSTED|Доверял
TRUTH|правда, истина
TRUTHFUL|правдивый
TRY|пробовать, пытаться
TRYING|ищу (место, адрес) (от to try for)
TUB|кадка, лохань, ушат
TUBE|труба (не pipe)
TUCKED|Подвернутый
TUESDAY|вторник
TUMBLE|падать, опрокидываться
TUMBLED|Кувыркался
TUMBLER|Тумблер
TUNE|мотив
TUNNEL|тоннель
TURF|дерн
TURK|Турок
TURKEY|индейка
TURN|поворачивать, вращать, оборот, поворот, очередь
TURNER|токарь
TURNIP|репа
TURNSTILE|Турникет
TURPENTINE|скипидар
TURTLE|Черепаха
TV|телевизор, телевидение
TWELFTH|двенадцатый
TWELVE|двенадцать
TWENTIETH|двадцатый
TWENTY|двадцать
TWICE|дважды, вдвое
TWIG|веточка, прутик
TWILIGHT|сумерки t-
TWIN|двойной, двойник, близнец
TWINKLE|мерцать, сверкать, мигать, мелькать
TWINS|близнецы
TWIST|вить(ся), крутить, скручивать
TWISTED|искривленный t-
TWIT|упрек, насмешка (не mock)
TWO|два
TYPE|тип, род t-
TYPES|Типы
TYPEWRITER|пишущая машинка
TYPICAL|типичный
TYRE|шина
UGLY|уродливый
ULTIMATE|последний
ULTIMATELY|В конечном счете
UMBRELLA|зонт
UN|ООН
UNABLE|неспособный
UNANIMOUS|единодушный, единогласный
UNANIMOUSLY|единодушно
UNAWARE|незнающий
UNCERTAIN|неясный (не от слова clear)
UNCHANGED|неизменившийся
UNCLE|дядя
UNCOMFORTABLE|неудобный u-
UNCOMMON|неординарный
UNCONSCIOUS|бессознательный
UNDER|под
UNDERGO|испытывать, подвергаться
UNDERGONE|Подвергнемся
UNDERGROUND|метрополитен, подземный, подпольный
UNDERLINE|подчеркивать
UNDERNEATH|вниз, внизу, под
UNDERSTAND|понимать, подразумевать
UNDERSTANDING|понимание, способность понять
UNDERSTOOD|понимал, понятый (от understand)
UNDERTAKE|предпринимать
UNDERTAKING|предприятие
UNDERWATER|Под водой
UNDERWEAR|нижнее белье
UNDESIRABLE|нежелательный
UNDO|развязывать, расстегивать
UNDOUBTEDLY|несомненно
UNDRESS|раздеваться
UNEASINESS|тревога, неловкость
UNEASY|встревоженный, неловкий
UNEXPECTED|неожиданный
UNFAIR|несправедливый
UNFINISHED|незаконченный
UNFIT|негодный, неподходящий
UNFORTUNATE|несчастный человек, горемыка u-
UNFORTUNATELY|к несчастью, к сожалению
UNGRATEFUL|неблагодарный u-
UNHAPPY|несчастный, неудачный (unhappy)
UNIFORM|форма, форменная одежда
UNION|союз
UNIONS|союзы (от union)
UNIQUE|Уникальный
UNIT|единица
UNITE|соединять(ся)
UNITED|объединенный
UNITS|единицы (от unit)
UNITY|единство
UNIVERSAL|всеобщий
UNIVERSE|мир, вселенная
UNIVERSITY|университет
UNKIND|недобрый
UNKNOWN|неизвестный
UNLEASH|развязывать (войну)
UNLESS|если не, пока не
UNLIKE|непохожий
UNLIKELY|маловероятный, вряд ли
UNLIMITED|неограниченный (не boundless)
UNLOAD|разгружать(ся), разряжать (оружие)
UNLOCK|отпирать
UNLUCKY|неудачный
UNMOVED|равнодушный
UNNATURAL|неестественный, противоестественный
UNNECESSARY|ненужный
UNOFFICIAL|неофициальный
UNPLEASANT|неприятный
UNPREDICTABLE|непредсказуемый u-
UNREASONABLE|неразумный, неблагоразумный
UNREGISTERED|Незарегистрированный
UNRESOLVED|нерешенный
UNREST|беспокойство (не bother, harass)
UNSEEN|Невидимый
UNSKILLED|неквалифицированный
UNSUCCESSFUL|неудачный
UNTIDY|неаккуратный
UNTIL|до
UNUSUAL|необычный
UNUSUALLY|необычно
UNWELCOME|нежеланный, неприятный
UNWILLING|несклонный, нерасположенный
UNWISE|неразумный
UNWORTHY|недостойный
UP|вверх, до предела, наверху
UPDATE|Модернизация
UPDATED|Обновленный
UPGRADE|Модернизировать
UPON|на
UPPER|верхний
UPRIGHT|прямой, вертикальный, честный, справедливый u-
UPROAR|шум, волнение (не shindy)
UPSET|беспорядок, расстройство, расстроенный
UPSTAIRS|наверху
UPWARD|направленный вверх
UPWARDS|вверх
URBAN|городской
URGE|понуждать
URGED|Побуждённый, подстёгнутый
URGENT|крайне необходимый, срочный
URGENTLY|срочно
URN|урна
US|нас, нам
USAGE|употребление, обычай
USE|использовать, употребить, польза, применение
USED|использованный, подержанный (от use)
USEFUL|полезный
USEFULLY|с пользой
USELESS|бесполезный
USER|потребитель
USERS|Пользователи
USING|пользование
USUAL|обыкновенный, обычный
USUALLY|обычно, обыкновенно
UTILITIES|Предприятия коммунального обслуживания
UTILITY|полезность, выгодность, удобства, коммунальные услуги u-
UTILIZE|использовать
UTMOST|крайний u-
UTTER|издавать (звук), произносить
UTTERED|Произнесенный
UTTERLY|совершенно (не perfect, totally)
VACANT|свободный, незанятый
VACATION|отпуск, каникулы
VACCINATION|прививка
VAGUE|неопределенный, смутный
VAGUELY|Неопределенно
VAIN|напрасный, тщетный
VALE|прощание
VALIANT|храбрый, мужественный (не от слова brave)
VALID|правильный v-
VALLEY|долина
VALLEYS|Долины
VALUABLE|ценный, дорогой
VALUATION|оценка
VALUE|ценность, цена, дорожить, ценить
VALUED|Оцененный
VALUER|оценщик
VALUES|Ценности
VALVE|клапан, створка, радио электронная лампа
VAN|фургон, багажный вагон
VANISH|исчезать, пропадать
VANISHED|Исчез
VANITY|тщеславие
VAPOUR|пар, пары
VARIABILITY|Изменчивость
VARIABLE|изменчивый, непостоянный
VARIABLES|Переменные
VARIATION|Изменение(разновидность)
VARIATIONS|Изменения(разновидности)
VARIED|Различный (не differ)
VARIETIES|Множества
VARIETY|разнообразие
VARIOUS|различный, разный
VARNISH|лак, лоск, лакировать
VARY|отличаться, расходиться
VARYING|Изменение -ing
VASE|ваза
VAST|обширный, громадный
VASTLY|значительно
VAULT|свод
VEAL|телятина
VEGETABLE|овощ, растение, овощной
VEGETABLES|овощи (от vegetable)
VEGETATION|Растительность
VEHEMENTLY|сильно v-
VEHICLE|транспортное средство
VEIL|завеса, покрывало
VEIN|вена, жила, жилка
VELVET|бархат, преимущество
VENEERING|Облицовывание -ing
VENGEANCE|месть, мщение
VENT|выпускать, испускать
VENTURE|предприятие, риск
VENTURES|предприятия (от venture)
VENUS|Венера
VERANDAH|Веранда
VERDURE|зелень ***d***
VERGE|грань, край
VERIFY|проверять, подтверждать
VERNON|Вернон
VERSE|стихи, поэзия
VERSION|версия
VERSIONS|Версии
VERTICAL|вертикальный
VERTICALLY|Вертикально
VERY|очень, тот самый
VESSEL|сосуд, судно
VEST|жилет (амер.), майка
VETERAN|ветеран
VEX|раздражать, сердить
VEXATION|досада, раздражение (не nuisance)
VEXED|сердил, раздражал (от vex)
VIA|через
VICE|порок
VICINITY|окрестности, соседство, близость
VICIOUS|порочный
VICTIM|жертва
VICTORIOUS|победоносный
VICTORY|победа
VIEW|взгляд, мнение, осматривать
VIEWED|Рассматриваемый
VIEWPOINT|точка зрения
VIEWS|Представления(виды)
VIGILANCE|бдительность
VIGOROUS|сильный v-
VIGOROUSLY|энергично 
VIGOUR|сила, энергия v-
VILLAGE|деревня
VILLAGER|сельский житель
VILLAIN|злодей, негодяй
VINE|виноградная лоза
VINEGAR|уксус
VIOLENCE|сила, неистовство, насилие
VIOLENT|яростный v-
VIOLENTLY|неистово v-
VIOLET|фиолетовый (не purple)
VIRTUAL|фактический
VIRTUE|добродетель
VISCOUNT|Виконт
VISIBLE|видимый, очевидный
VISION|зрение, видение
VISIT|визит, посещать, навещать
VISITED|посетил (от visit)
VISITING|приезжий -ing
VISITOR|гость
VISITS|Посещения
VISUAL|зрительный, наглядный
VITAL|жизненный, крайне необходимый
VIVID|живой, яркий
VOCATION|призвание
VOICE|голос
VOID|лишенный, недействительный (юр.)
VOLCANO|вулкан
VOLUME|объем, громкость
VOLUNTARY|добровольный
VOTE|голос (на выборах), голосование, голосовать
VOW|обет, клятва
VOYAGE|путешествие v-
WAD|прокладывать
WADE|пробираться, продираться
WAG|махать, трясти
WAGE|заработная плата
WAGER|держать пари, рисковать
WAGGONER|Извозчик
WAGON|повозка 
WAIL|вопль, вой, вопить, выть
WAILED|Вопил
WAILING|Вопящий -ing
WAIST|талия
WAISTCOAT|жилет
WAIT|ждать, ожидать, ожидание
WAITED|ждал (от wait)
WAITER|официант
WAITING|ждать (от to keep waiting)
WAITRESS|официантка
WAKE|будить, просыпаться
WALK|гулять, ходить пешком (не hike)
WALKED|гулял (от walk)
WALKING|гуляющий
WALL|стена
WALLACE|Уоллис
WALLET|бумажник
WALLPAPER|обои
WALNUT|грецкий орех
WALRUS|морж
WALTER|Уолтер
WAN|бледный, изнуренный
WAND|Палочка
WANDER|бродить, блуждать
WANDERER|странник (не stranger)
WANDERING|блуждание 
WANT|хотеть, желать, нуждаться в
WANTED|хотел, желанный (от want)
WANTING|Желание
WANTS|хочет, желает, нуждается в (от want)
WAR|война, воевать
WARD|опека
WARDROBE|гардероб
WAREHOUSE|склад, пакгауз
WARILY|осторожно
WARM|теплый, согревать
WARMLY|тепло
WARMTH|тепло, теплота, сердечность
WARN|предупреждать w-
WARNING|предупреждение
WARRANT|полномочие, ордер, гарантировать
WARRIOR|воин (w-)
WARRIORS|Воины
WARS|Войны
WARY|осторожный
WAS|был (от be)
WASH|мыть, стирать, мытье, стирка
WASHED|мыл, вымытый (от wash)
WASP|оса
WASPISH|злой, раздражительный (не vicious)
WASTE|тратить, использованный, негодный
WASTED|Потраченный впустую
WASTEFUL|расточительный
WATCH|часы, cмотреть, наблюдать
WATCHER|сторож, наблюдатель
WATCHES|часы (от watch)
WATCHFUL|бдительный (не vigilant)
WATCHING|просмотр
WATCHMAN|(ночной) сторож
WATER|вода, поливать, разбавлять
WATERPROOF|непромокаемый, непромокаемый плащ
WATERY|водянистый, дождевой, бесцветный
WAVE|волна
WAVED|Махал
WAVER|колебаться, быть в нерешительности
WAVING|Помахивание
WAVY|волнистый, бурный
WAX|воск, восковой
WAXWORKS|Восковые фигуры
WAY|дорога, путь, способ
WAYFARER|путник, пешеход
WE|мы
WEAK|слабый
WEAKNESS|слабость
WEALTH|богатство
WEALTHY|богатый (w-)
WEAPON|оружие
WEAPONS|Оружие
WEAR|одежда, носить, быть одетым
WEARINESS|усталость
WEARISOME|скучный, надоедливый
WEARY|усталый, утомительный, утомлять(ся), устать, потерять терпение
WEATHER|погода
WEAVE|ткать, плести
WEB|ткань, лента, перемычка
WEDDING|свадьба, венчание
WEDGE|клин
WEDNESDAY|среда
WEED|сорняк, полоть
WEEK|неделя
WEEKEND|выходные
WEEKLY|еженедельный, еженедельно
WEEP|плакать
WEEPING|Плач *e-ing
WEIGH|взвешивать, весить
WEIGHT|вес, тяжесть, груз
WEIGHTY|веский
WEIRD|судьба, рок, таинственный, странный
WELCOME|желанный, гостеприимство
WELFARE|благосостояние
WELL|хорошо, очень, добро, здоровый (не good)
WENT|шел, ехал (от go)
WEPT|Плакал
WERE|были (от be)
WEST|запад
WESTERN|западный
WET|мокрый
WHALE|кит
WHAT|что, какой
WHATEVER|что бы ни
WHEAT|пшеница
WHEEL|колесо
WHEELBARROW|тачка
WHEELED|Колесный
WHEELS|Колеса
WHEN|когда
WHENCE|Откуда
WHENEVER|когда бы ни
WHERE|где, куда
WHEREAS|тогда как, принимая во внимание
WHEREBY|чем, при помощи
WHEREUPON|после чего, сразу после; немедленно после
WHEREVER|где бы ни, куда бы ни
WHETHER|ли
WHICH|который
WHILE|пока, в то время как, тогда как
WHILST|Пока
WHINE|визг, скулить
WHIP|кнут, хлыст, хлестать, сечь, взбивать (сливки, яйца)
WHIRL|вихрь
WHIRLWIND|вихрь
WHISKERS|бакенбарды, усы (у животных)
WHISPER|шепот, шептать
WHISPERING|Шептание
WHISTLE|свист, свистеть
WHISTLED|Свистел
WHISTLING|Свист
WHITE|белый
WHO|кто
WHOEVER|кто бы ни
WHOLE|целый, весь, целое
WHOLESOME|полезный, здоровый, благотворный
WHOLLY|полностью
WHOM|кому, кого
WHOSE|чей
WHY|почему
WICKED|злой
WIDE|широкий
WIDELY|широко
WIDEN|расширять(ся)
WIDOW|вдова
WIDTH|ширина
WIFE|жена
WIG|парик
WILD|исступленный, безумный
WILDERNESS|пустыня, глушь
WILDLY|Дико
WILFRID|Вилфрид 
WILL|вспомогательный глагол будущего времени
WILLIAM|Уильям
WILLING|готовый, охотно делающий что-либо
WILLINGLY|охотно
WILLOW|ива
WIN|выигрывать, побеждать
WIND|ветер, виток, виться, наматывать
WINDFALL|неожиданная удача
WINDING|изгиб w- -ing
WINDOW|окно, оконный
WINDOWS|окна (от window)
WINDS|Ветры
WINDY|ветреный
WINE|вино, винный, пить вино
WING|крыло
WINGS|крылья 
WINK|моргать, мигать, моргание, мигание
WINNER|победитель
WINNING|выигрывающий, победа (-ing)
WINTER|зима
WIPE|вытирать
WIPED|Вытертый
WIRE|переводить телеграфом (деньги)
WIRELESS|беспроволочный, радио
WISDOM|мудрость
WISE|мудрый
WISELY|мудро
WISH|желание, желать
WISHES|пожелания (от wish)
WISHING|Пожелание -ing
WIT|ум, остроумие, остроумный человек, остряк
WITH|с
WITHDRAW|брать назад, забирать
WITHDREW|Отошел
WITHIN|внутри, внутрь (w-)
WITHOUT|без
WITNESS|свидетель
WITNESSED|Засвидетельствованный
WITS|Остроумие
WIZARD|колдун, специалист своего дела 
WIZARDS|Волшебники
WOKE|будил (от wake)
WOKEN|разбуженный (от wake)
WOLF|волк
WOLVES|Волки
WOMAN|женщина
WOMEN|женщины (от woman)
WON|победил, побежденный (от win)
WONDER|удивляться
WONDERFUL|замечательный, чудесный
WONDERFULLY|Чудесно
WONDERING|удивляющийся, интересующийся (-ing) 
WOOD|лес, древесина, дрова
WOODEN|деревянный
WOODLAND|лесистая местность
WOODLANDS|Лесистые местности
WOOL|шерсть
WOOLLEN|шерстяной
WORD|слово, обещание
WORDING|редакция, форма выражения, формулировка -ing
WORDS|слова (от word)
WORE|носил, изнашивал (w-) 
WORK|работать, делать, работа, труд
WORKED|работал, сработанный (от work)
WORKER|рабочий
WORKING|делающий, творящий (от work)
WORKMAN|рабочий (мужик)
WORKROOM|Рабочее помещение
WORKSHOP|мастерская
WORLD|мир, свет
WORLDS|Миры
WORM|червь, глист, ничтожество (перен.)
WORN|потёртый, изношенный 
WORRY|беспокоиться
WORSE|хуже (от bad)
WORSHIP|поклоняться (не regards)
WORST|наихудший
WORTH|стоящий, заслуживающий
WORTHLESS|ничего не стоящий, дрянной
WORTHY|достойный
WOULD|вспомогательный, модальный глагол (от will)
WOUND|рана
WOUNDED|раненый
WOW|Ничего себе
WRAP|завертывать, шаль, плед, обертка
WRATH|гнев, ярость
WRECK|крушение (w-)
WREN|Крапивник
WRESTLE|бороться
WRETCH|несчастный, негодяй
WRETCHED|несчастный, жалкий
WRING|скручивать, выжимать
WRINKLE|морщина, морщить(ся)
WRIST|наручный, запястье
WRITE|писать, записывать
WRITER|писатель
WRITING|письменность (-ing)
WRITTEN|письменный, написанный
WRONG|неправильный, не тот
WROTE|писал, написанный (от write)
YACHT|яхта
YARD|ярд, двор
YAWN|зевать, зевота
YE|Вы
YEAH|да 
YEAR|год
YEARLING|козленок, ягненок
YELL|пронзительный крик, кричать, вопить
YELLOW|желтый
YES|да
YESTERDAY|вчера
YET|однако, еще
YIELD|приносить y-
YIELDED|Выданный
YIELDING|Выдающий(уступающий) -ing
YOKE|иго, ярмо
YONDER|вон тот 
YOU|вы, ты
YOUNG|молодой
YOUNGER|моложе (от young)
YOUNGEST|самый молодой, младший (от young)
YOUNGSTER|юноша
YOUR|ваш, твой
YOURS|ваш, ваши, твой, твои
YOURSELF|сам, сами
YOURSELVES|Самостоятельно
YOUTH|молодежь
YOUTHFUL|юный, юношеский y-
YURI|Юрий
ZEAL|усердие, рвение
ZERO|ноль
ZIGZAG|Зигзаг
ZINC|цинк, цинковый, оцинковывать
ZONE|зона
ZOO|зоопарк
ZOOLOGICAL|Зоологический
